Caller	Callee
org.apache.commons.beanutils.BeanUtils.getIndexedProperty(Object,String)	org.apache.commons.beanutils.PropertyUtils.getIndexedProperty(Object,String)
org.apache.commons.beanutils.MappedPropertyDescriptor.internalFindMethod(Class,String,int,Class[])	org.apache.commons.beanutils.MappedPropertyDescriptor.getPublicDeclaredMethods(Class)
org.apache.commons.beanutils.DynaPropertyUtilsTestCase.setUp()	org.apache.commons.beanutils.DynaClass.newInstance()
org.apache.commons.beanutils.PropertyUtilsTestCase.testGetMappedValues()	org.apache.commons.beanutils.PropertyUtils.getNestedProperty(Object,String)
org.apache.commons.beanutils.DynaPropertyUtilsTestCase.testSetSimpleString()	org.apache.commons.beanutils.PropertyUtils.setSimpleProperty(Object,String,Object)
org.apache.commons.beanutils.PropertyUtilsTestCase.testGetDescriptorsArguments()	org.apache.commons.beanutils.PropertyUtils.getPropertyDescriptors(Class)
org.apache.commons.beanutils.BeanUtils.getMappedProperty(Object,String)	org.apache.commons.beanutils.PropertyUtils.getMappedProperty(Object,String)
org.apache.commons.beanutils.PropertyUtils.getMappedProperty(Object,String,String)	org.apache.commons.beanutils.MappedPropertyDescriptor.getMappedReadMethod()
org.apache.commons.beanutils.DynaBeanUtilsTestCase.testCopyPropertiesDynaBean()	org.apache.commons.beanutils.DynaBean.set(String,Object)
org.apache.commons.beanutils.BasicDynaBeanTestCase.testGetDescriptors()	org.apache.commons.beanutils.DynaClass.getDynaProperties()
org.apache.commons.beanutils.BasicDynaBeanTestCase.testSetSimpleFloat()	org.apache.commons.beanutils.DynaBean.set(String,Object)
org.apache.commons.beanutils.BeanUtilsTestCase.testGetArrayProperty()	org.apache.commons.beanutils.TestBean.getStringArray()
org.apache.commons.beanutils.PropertyUtilsTestCase.testSetSimpleDouble()	org.apache.commons.beanutils.PropertyUtils.setSimpleProperty(Object,String,Object)
org.apache.commons.beanutils.DynaPropertyUtilsTestCase.testSetSimpleFloat()	org.apache.commons.beanutils.PropertyUtils.setSimpleProperty(Object,String,Object)
org.apache.commons.beanutils.PropertyUtilsTestCase.testSetNestedString()	org.apache.commons.beanutils.PropertyUtils.setNestedProperty(Object,String,Object)
org.apache.commons.beanutils.converters.LongArrayConverter.convert(Class,Object)	org.apache.commons.beanutils.converters.AbstractArrayConverter.parseElements(String)
org.apache.commons.beanutils.PropertyUtilsTestCase.testGetSimpleShort()	org.apache.commons.beanutils.PropertyUtils.getSimpleProperty(Object,String)
org.apache.commons.beanutils.PropertyUtils.getSimpleProperty(Object,String)	org.apache.commons.beanutils.PropertyUtils.getPropertyDescriptor(Object,String)
org.apache.commons.beanutils.PropertyUtils.describe(Object)	org.apache.commons.beanutils.PropertyUtils.getPropertyDescriptors(Object)
org.apache.commons.beanutils.PropertyUtilsTestCase.testSetSimpleFloat()	org.apache.commons.beanutils.TestBean.getFloatProperty()
org.apache.commons.beanutils.PropertyUtilsTestCase.testSetNestedWriteOnly()	org.apache.commons.beanutils.TestBean.getNested()
org.apache.commons.beanutils.DynaPropertyUtilsTestCase.setUp()	org.apache.commons.beanutils.DynaPropertyUtilsTestCase.createDynaClass()
org.apache.commons.beanutils.BeanUtilsTestCase.testCopyPropertiesDynaBean()	org.apache.commons.beanutils.TestBean.getStringProperty()
org.apache.commons.beanutils.BasicDynaBean.remove(String,String)	org.apache.commons.beanutils.BasicDynaBean.getDynaProperty(String)
org.apache.commons.beanutils.ConvertingWrapDynaBean.set(String,Object)	org.apache.commons.beanutils.WrapDynaBean.getDynaProperty(String)
org.apache.commons.beanutils.WrapDynaBean.get(String,int)	org.apache.commons.beanutils.WrapDynaBean.getDynaProperty(String)
org.apache.commons.beanutils.BasicDynaBeanTestCase.testGetDescriptorBase(String,Class)	org.apache.commons.beanutils.DynaProperty.getType()
org.apache.commons.beanutils.ConvertUtilsTestCase.testPositiveArray()	org.apache.commons.beanutils.ConvertUtils.convert(String[],Class)
org.apache.commons.beanutils.BeanUtils.getMappedProperty(Object,String,String)	org.apache.commons.beanutils.PropertyUtils.getMappedProperty(Object,String,String)
org.apache.commons.beanutils.converters.ShortArrayConverter.convert(Class,Object)	org.apache.commons.beanutils.converters.AbstractArrayConverter.parseElements(String)
org.apache.commons.beanutils.PropertyUtilsTestCase.testMappedPropertyType()	org.apache.commons.beanutils.MappedPropertyDescriptor.getMappedPropertyType()
org.apache.commons.beanutils.DynaPropertyUtilsTestCase.testGetNestedShort()	org.apache.commons.beanutils.TestBean.getShortProperty()
org.apache.commons.beanutils.DynaPropertyUtilsTestCase.testSetIndexedValues()	org.apache.commons.beanutils.PropertyUtils.getIndexedProperty(Object,String)
org.apache.commons.beanutils.PropertyUtilsTestCase.testGetSimpleArguments()	org.apache.commons.beanutils.PropertyUtils.getSimpleProperty(Object,String)
org.apache.commons.beanutils.ResultSetIterator.hasNext()	org.apache.commons.beanutils.ResultSetIterator.advance()
org.apache.commons.beanutils.PropertyUtilsTestCase.testGetSimpleUnknown()	org.apache.commons.beanutils.PropertyUtils.getSimpleProperty(Object,String)
org.apache.commons.beanutils.PropertyUtilsTestCase.testSetMappedValues()	org.apache.commons.beanutils.PropertyUtils.setMappedProperty(Object,String,Object)
org.apache.commons.beanutils.BeanUtilsTestCase.testCopyPropertiesStandard()	org.apache.commons.beanutils.TestBean.setIntProperty(int)
org.apache.commons.beanutils.WrapDynaBean.get(String)	org.apache.commons.beanutils.WrapDynaBean.getDynaProperty(String)
org.apache.commons.beanutils.BasicDynaBeanTestCase.testMappedContains()	org.apache.commons.beanutils.DynaBean.contains(String,String)
org.apache.commons.beanutils.PropertyUtilsTestCase.testSetSimpleString()	org.apache.commons.beanutils.TestBean.getStringProperty()
org.apache.commons.beanutils.PropertyUtilsTestCase.setUp()	org.apache.commons.beanutils.priv.PrivateBeanFactory.createSubclass()
org.apache.commons.beanutils.BasicDynaBeanTestCase.testSetSimpleString()	org.apache.commons.beanutils.DynaBean.set(String,Object)
org.apache.commons.beanutils.BeanUtilsTestCase.testCopyPropertiesStandard()	org.apache.commons.beanutils.TestBean.setBooleanProperty(boolean)
org.apache.commons.beanutils.PropertyUtilsTestCase.testSetSimpleIndexed()	org.apache.commons.beanutils.PropertyUtils.setSimpleProperty(Object,String,Object)
org.apache.commons.beanutils.ConvertUtilsTestCase.testPositiveStringArray()	org.apache.commons.beanutils.ConvertUtils.convert(String,Class)
org.apache.commons.beanutils.DynaPropertyUtilsTestCase.testSetIndexedValues()	org.apache.commons.beanutils.PropertyUtils.getIndexedProperty(Object,String,int)
org.apache.commons.beanutils.DynaPropertyUtilsTestCase.testSetMappedArguments()	org.apache.commons.beanutils.PropertyUtils.setMappedProperty(Object,String,String,Object)
org.apache.commons.beanutils.DynaBeanUtilsTestCase.testGetNestedProperty()	org.apache.commons.beanutils.TestBean.getStringProperty()
org.apache.commons.beanutils.DynaPropertyUtilsTestCase.testGetSimpleUnknown()	org.apache.commons.beanutils.PropertyUtils.getSimpleProperty(Object,String)
org.apache.commons.beanutils.DynaBeanUtilsTestCase.testCopyPropertiesStandard()	org.apache.commons.beanutils.DynaBean.get(String)
org.apache.commons.beanutils.DynaPropertyUtilsTestCase.testGetMappedValues()	org.apache.commons.beanutils.PropertyUtils.getMappedProperty(Object,String)
org.apache.commons.beanutils.PropertyUtilsTestCase.testGetPropertyType()	org.apache.commons.beanutils.PropertyUtils.getPropertyType(Object,String)
org.apache.commons.beanutils.PropertyUtilsTestCase.testSetNestedShort()	org.apache.commons.beanutils.PropertyUtils.setNestedProperty(Object,String,Object)
org.apache.commons.beanutils.BeanUtils.setProperty(Object,String,Object)	org.apache.commons.beanutils.DynaBean.getDynaClass()
org.apache.commons.beanutils.PropertyUtils.getMappedProperty(Object,String,String)	org.apache.commons.beanutils.DynaBean.getDynaClass()
org.apache.commons.beanutils.DynaBeanUtilsTestCase.testPopulateNested()	org.apache.commons.beanutils.TestBean.getDoubleProperty()
org.apache.commons.beanutils.BasicDynaBeanTestCase.testSetMappedValues()	org.apache.commons.beanutils.DynaBean.set(String,String,Object)
org.apache.commons.beanutils.ConvertUtilsTestCase.testObjectToStringScalar()	org.apache.commons.beanutils.ConvertUtils.convert(Object)
org.apache.commons.beanutils.PropertyUtilsTestCase.testGetDescriptorArguments()	org.apache.commons.beanutils.PropertyUtils.getPropertyDescriptor(Object,String)
org.apache.commons.beanutils.BasicDynaBeanTestCase.testGetDescriptors()	org.apache.commons.beanutils.DynaProperty.getName()
org.apache.commons.beanutils.DynaPropertyUtilsTestCase.testSetNestedReadOnly()	org.apache.commons.beanutils.TestBean.getWriteOnlyPropertyValue()
org.apache.commons.beanutils.PropertyUtilsTestCase.testGetSimpleString()	org.apache.commons.beanutils.PropertyUtils.getSimpleProperty(Object,String)
org.apache.commons.beanutils.BeanUtils.copyProperty(Object,String,Object)	org.apache.commons.beanutils.PropertyUtils.setSimpleProperty(Object,String,Object)
org.apache.commons.beanutils.ResultSetIterator.set(String,Object)	org.apache.commons.beanutils.ResultSetDynaClass.getDynaProperty(String)
org.apache.commons.beanutils.DynaPropertyUtilsTestCase.testSetSimpleBoolean()	org.apache.commons.beanutils.DynaBean.get(String)
org.apache.commons.beanutils.MethodUtils.invokeMethod(Object,String,Object[])	org.apache.commons.beanutils.MethodUtils.invokeMethod(Object,String,Object[],Class[])
org.apache.commons.beanutils.DynaBeanUtilsTestCase.testPopulateArrayElements()	org.apache.commons.beanutils.DynaBean.get(String,int)
org.apache.commons.beanutils.DynaPropertyUtilsTestCase.testSetNestedDouble()	org.apache.commons.beanutils.TestBean.getDoubleProperty()
org.apache.commons.beanutils.DynaPropertyUtilsTestCase.testSetNestedArguments()	org.apache.commons.beanutils.PropertyUtils.setNestedProperty(Object,String,Object)
org.apache.commons.beanutils.BeanUtilsTestCase.testCopyPropertiesDynaBean()	org.apache.commons.beanutils.TestBean.getLongProperty()
org.apache.commons.beanutils.DynaBeanUtilsTestCase.testCopyPropertiesStandard()	org.apache.commons.beanutils.TestBean.setLongProperty(long)
org.apache.commons.beanutils.BasicDynaBeanTestCase.testGetSimpleInt()	org.apache.commons.beanutils.DynaBean.get(String)
org.apache.commons.beanutils.PropertyUtilsTestCase.testSetMappedValues()	org.apache.commons.beanutils.PropertyUtils.getMappedProperty(Object,String,String)
org.apache.commons.beanutils.BeanUtils.setProperty(Object,String,Object)	org.apache.commons.beanutils.PropertyUtils.setMappedProperty(Object,String,String,Object)
org.apache.commons.beanutils.BeanUtilsTestCase.testCopyPropertiesStandard()	org.apache.commons.beanutils.TestBean.getStringArray()
org.apache.commons.beanutils.PropertyUtils.getProperty(Object,String)	org.apache.commons.beanutils.PropertyUtils.getNestedProperty(Object,String)
org.apache.commons.beanutils.BeanUtils.describe(Object)	org.apache.commons.beanutils.PropertyUtils.getPropertyDescriptors(Object)
org.apache.commons.beanutils.BasicDynaBeanTestCase.testGetDescriptorShort()	org.apache.commons.beanutils.BasicDynaBeanTestCase.testGetDescriptorBase(String,Class)
org.apache.commons.beanutils.BasicDynaBeanTestCase.testSetSimpleLong()	org.apache.commons.beanutils.DynaBean.get(String)
org.apache.commons.beanutils.BasicDynaBeanTestCase.setUp()	org.apache.commons.beanutils.DynaBean.set(String,Object)
org.apache.commons.beanutils.PropertyUtilsTestCase.testSetIndexedValues()	org.apache.commons.beanutils.PropertyUtils.getIndexedProperty(Object,String)
org.apache.commons.beanutils.DynaPropertyUtilsTestCase.testSetIndexedArguments()	org.apache.commons.beanutils.PropertyUtils.setIndexedProperty(Object,String,Object)
org.apache.commons.beanutils.MethodUtils.getAccessibleMethod(Class,String,Class[])	org.apache.commons.beanutils.MethodUtils.getAccessibleMethod(Method)
org.apache.commons.beanutils.ConvertUtilsTestCase.testPositiveIntegerArray()	org.apache.commons.beanutils.ConvertUtils.convert(String,Class)
org.apache.commons.beanutils.DynaPropertyUtilsTestCase.testGetMappedArguments()	org.apache.commons.beanutils.PropertyUtils.getMappedProperty(Object,String)
org.apache.commons.beanutils.DynaPropertyUtilsTestCase.testGetSimpleArguments()	org.apache.commons.beanutils.PropertyUtils.getSimpleProperty(Object,String)
org.apache.commons.beanutils.PropertyUtilsTestCase.testSetIndexedArguments()	org.apache.commons.beanutils.PropertyUtils.setIndexedProperty(Object,String,Object)
org.apache.commons.beanutils.BeanUtilsTestCase.testCopyPropertiesDynaBean()	org.apache.commons.beanutils.DynaClass.newInstance()
org.apache.commons.beanutils.PropertyUtilsTestCase.testGetDescriptorSecond()	org.apache.commons.beanutils.PropertyUtilsTestCase.testGetDescriptorBase(String,String,String)
org.apache.commons.beanutils.BeanUtils.getMappedProperty(Object,String,String)	org.apache.commons.beanutils.ConvertUtils.convert(Object)
org.apache.commons.beanutils.BasicDynaBeanTestCase.testSetSimpleBoolean()	org.apache.commons.beanutils.DynaBean.get(String)
org.apache.commons.beanutils.BeanUtils.copyProperties(Object,Object)	org.apache.commons.beanutils.PropertyUtils.getPropertyDescriptors(Object)
org.apache.commons.beanutils.PropertyUtils.getPropertyDescriptor(Object,String)	org.apache.commons.beanutils.PropertyUtils.getPropertyDescriptors(Object)
org.apache.commons.beanutils.DynaBeanUtilsTestCase.testGetSimpleProperty()	org.apache.commons.beanutils.DynaBean.get(String)
org.apache.commons.beanutils.PropertyUtilsTestCase.testSetIndexedValues()	org.apache.commons.beanutils.PropertyUtils.getIndexedProperty(Object,String,int)
org.apache.commons.beanutils.BasicDynaClass.setProperties(DynaProperty[])	org.apache.commons.beanutils.DynaProperty.getName()
org.apache.commons.beanutils.PropertyUtils.setNestedProperty(Object,String,Object)	org.apache.commons.beanutils.PropertyUtils.setIndexedProperty(Object,String,Object)
org.apache.commons.beanutils.ConvertUtilsTestCase.testPositiveScalar()	org.apache.commons.beanutils.ConvertUtils.convert(String,Class)
org.apache.commons.beanutils.PropertyUtilsTestCase.testGetNestedDouble()	org.apache.commons.beanutils.PropertyUtils.getNestedProperty(Object,String)
org.apache.commons.beanutils.MethodUtilsTestCase.testInvokeExactMethod()	org.apache.commons.beanutils.priv.PrivateBeanFactory.create()
org.apache.commons.beanutils.PropertyUtilsTestCase.testGetReadMethodBasic()	org.apache.commons.beanutils.PropertyUtilsTestCase.testGetReadMethod(Object,String[],String)
org.apache.commons.beanutils.WrapDynaClass.introspect()	org.apache.commons.beanutils.PropertyUtils.getPropertyDescriptors(Class)
org.apache.commons.beanutils.BasicDynaBeanTestCase.testGetSimpleLong()	org.apache.commons.beanutils.DynaBean.get(String)
org.apache.commons.beanutils.BasicDynaBeanTestCase.testSetSimpleBoolean()	org.apache.commons.beanutils.DynaBean.set(String,Object)
org.apache.commons.beanutils.BasicDynaBeanTestCase.testSetSimpleDouble()	org.apache.commons.beanutils.DynaBean.get(String)
org.apache.commons.beanutils.DynaPropertyUtilsTestCase.testSetNestedFloat()	org.apache.commons.beanutils.TestBean.getFloatProperty()
org.apache.commons.beanutils.BasicDynaBeanTestCase.testMappedRemove()	org.apache.commons.beanutils.DynaBean.contains(String,String)
org.apache.commons.beanutils.DynaBeanUtilsTestCase.testPopulateScalar()	org.apache.commons.beanutils.DynaBean.get(String)
org.apache.commons.beanutils.BeanUtils.setProperty(Object,String,Object)	org.apache.commons.beanutils.PropertyUtils.getPropertyDescriptor(Object,String)
org.apache.commons.beanutils.PropertyUtils.getMappedProperty(Object,String,String)	org.apache.commons.beanutils.PropertyUtils.getPropertyDescriptor(Object,String)
org.apache.commons.beanutils.BeanUtilsTestCase.testPopulateArrayElements()	org.apache.commons.beanutils.BeanUtils.populate(Object,Map)
org.apache.commons.beanutils.PropertyUtilsTestCase.testDescribe()	org.apache.commons.beanutils.BeanUtils.describe(Object)
org.apache.commons.beanutils.BeanUtilsTestCase.testCopyPropertiesStandard()	org.apache.commons.beanutils.TestBean.getStringProperty()
org.apache.commons.beanutils.PropertyUtilsTestCase.testGetSimpleBoolean()	org.apache.commons.beanutils.TestBean.getBooleanProperty()
org.apache.commons.beanutils.MethodUtils.invokeExactMethod(Object,String,Object)	org.apache.commons.beanutils.MethodUtils.invokeExactMethod(Object,String,Object[])
org.apache.commons.beanutils.DynaPropertyUtilsTestCase.testGetNestedInt()	org.apache.commons.beanutils.PropertyUtils.getNestedProperty(Object,String)
org.apache.commons.beanutils.BasicDynaBeanTestCase.testSetSimpleString()	org.apache.commons.beanutils.DynaBean.get(String)
org.apache.commons.beanutils.DynaBeanUtilsTestCase.testCopyPropertiesStandard()	org.apache.commons.beanutils.TestBean.setBooleanProperty(boolean)
org.apache.commons.beanutils.PropertyUtils.setSimpleProperty(Object,String,Object)	org.apache.commons.beanutils.PropertyUtils.getWriteMethod(PropertyDescriptor)
org.apache.commons.beanutils.DynaBeanUtilsTestCase.testGetSimpleProperty()	org.apache.commons.beanutils.BeanUtils.getSimpleProperty(Object,String)
org.apache.commons.beanutils.BeanUtilsTestCase.testPopulateScalar()	org.apache.commons.beanutils.TestBean.getDoubleProperty()
org.apache.commons.beanutils.DynaResultSetTestCase.testGetDynaProperties()	org.apache.commons.beanutils.ResultSetDynaClass.getDynaProperties()
org.apache.commons.beanutils.ConvertUtils.convert(String,Class)	org.apache.commons.beanutils.Converter.convert(Class,Object)
org.apache.commons.beanutils.DynaBeanUtilsTestCase.testCopyPropertiesDynaBean()	org.apache.commons.beanutils.DynaBean.get(String)
org.apache.commons.beanutils.PropertyUtils.getSimpleProperty(Object,String)	org.apache.commons.beanutils.DynaBean.getDynaClass()
org.apache.commons.beanutils.PropertyUtilsTestCase.testSetNestedWriteOnly()	org.apache.commons.beanutils.PropertyUtils.setNestedProperty(Object,String,Object)
org.apache.commons.beanutils.BeanUtilsTestCase.testCopyPropertiesStandard()	org.apache.commons.beanutils.TestBean.setDoubleProperty(double)
org.apache.commons.beanutils.DynaPropertyUtilsTestCase.testGetNestedDouble()	org.apache.commons.beanutils.PropertyUtils.getNestedProperty(Object,String)
org.apache.commons.beanutils.DynaPropertyUtilsTestCase.testGetNestedUnknown()	org.apache.commons.beanutils.PropertyUtils.getNestedProperty(Object,String)
org.apache.commons.beanutils.BasicDynaBean.get(String)	org.apache.commons.beanutils.DynaProperty.getType()
org.apache.commons.beanutils.DynaPropertyUtilsTestCase.testGetNestedReadOnly()	org.apache.commons.beanutils.DynaBean.get(String)
org.apache.commons.beanutils.BeanUtilsTestCase.testGetGeneralProperty()	org.apache.commons.beanutils.TestBean.getIntIndexed(int)
org.apache.commons.beanutils.ConvertUtilsTestCase.testPositiveStringArray()	org.apache.commons.beanutils.ConvertUtilsTestCase.checkStringArray(Object,String[])
org.apache.commons.beanutils.DynaResultSetTestCase.testGetDynaProperty()	org.apache.commons.beanutils.ResultSetDynaClass.getDynaProperty(String)
org.apache.commons.beanutils.BeanUtils.cloneBean(Object)	org.apache.commons.beanutils.PropertyUtils.copyProperties(Object,Object)
org.apache.commons.beanutils.PropertyUtilsTestCase.testGetSimpleDouble()	org.apache.commons.beanutils.TestBean.getDoubleProperty()
org.apache.commons.beanutils.BasicDynaBean.set(String,Object)	org.apache.commons.beanutils.BasicDynaBean.getDynaProperty(String)
org.apache.commons.beanutils.PropertyUtilsTestCase.testGetSimpleDouble()	org.apache.commons.beanutils.PropertyUtils.getSimpleProperty(Object,String)
org.apache.commons.beanutils.PropertyUtils.setNestedProperty(Object,String,Object)	org.apache.commons.beanutils.PropertyUtils.setSimpleProperty(Object,String,Object)
org.apache.commons.beanutils.PropertyUtils.getSimpleProperty(Object,String)	org.apache.commons.beanutils.DynaClass.getDynaProperty(String)
org.apache.commons.beanutils.BasicDynaBeanTestCase.testSetSimpleLong()	org.apache.commons.beanutils.DynaBean.set(String,Object)
org.apache.commons.beanutils.DynaPropertyUtilsTestCase.testSetMappedValues()	org.apache.commons.beanutils.PropertyUtils.setMappedProperty(Object,String,String,Object)
org.apache.commons.beanutils.BeanUtils.setProperty(Object,String,Object)	org.apache.commons.beanutils.DynaClass.getDynaProperty(String)
org.apache.commons.beanutils.PropertyUtils.setIndexedProperty(Object,String,int,Object)	org.apache.commons.beanutils.DynaBean.getDynaClass()
org.apache.commons.beanutils.PropertyUtilsTestCase.testSetSimpleLong()	org.apache.commons.beanutils.PropertyUtils.setSimpleProperty(Object,String,Object)
org.apache.commons.beanutils.MappedPropertyDescriptor.isSubclass(Class,Class)	org.apache.commons.beanutils.MappedPropertyDescriptor.isSubclass(Class,Class)
org.apache.commons.beanutils.ConvertUtilsTestCase.testObjectToStringArray()	org.apache.commons.beanutils.ConvertUtils.convert(Object)
org.apache.commons.beanutils.BasicDynaBeanTestCase.setUp()	org.apache.commons.beanutils.DynaClass.newInstance()
org.apache.commons.beanutils.WrapDynaBeanTestCase.testMappedRemove()	org.apache.commons.beanutils.DynaBean.remove(String,String)
org.apache.commons.beanutils.BeanUtils.copyProperties(Object,Object)	org.apache.commons.beanutils.BeanUtils.copyProperty(Object,String,Object)
org.apache.commons.beanutils.ConvertUtilsTestCase.testNegativeIntegerArray()	org.apache.commons.beanutils.ConvertUtils.convert(String,Class)
org.apache.commons.beanutils.WrapDynaBean.getDynaProperty(String)	org.apache.commons.beanutils.DynaClass.getDynaProperty(String)
org.apache.commons.beanutils.BeanUtilsTestCase.testPopulateNested()	org.apache.commons.beanutils.TestBean.getDoubleProperty()
org.apache.commons.beanutils.PropertyUtilsTestCase.testGetDescriptorFloat()	org.apache.commons.beanutils.PropertyUtilsTestCase.testGetDescriptorBase(String,String,String)
org.apache.commons.beanutils.BeanUtils.setProperty(Object,String,Object)	org.apache.commons.beanutils.PropertyUtils.setIndexedProperty(Object,String,int,Object)
org.apache.commons.beanutils.BasicDynaBeanTestCase.testSetSimpleFloat()	org.apache.commons.beanutils.DynaBean.get(String)
org.apache.commons.beanutils.PropertyUtilsTestCase.testGetDescriptorBoolean()	org.apache.commons.beanutils.PropertyUtilsTestCase.testGetDescriptorBase(String,String,String)
org.apache.commons.beanutils.PropertyUtils.getIndexedProperty(Object,String,int)	org.apache.commons.beanutils.DynaClass.getDynaProperty(String)
org.apache.commons.beanutils.WrapDynaBean.set(String,Object)	org.apache.commons.beanutils.PropertyUtils.setSimpleProperty(Object,String,Object)
org.apache.commons.beanutils.DynaBeanUtilsTestCase.testCopyPropertiesDynaBean()	org.apache.commons.beanutils.DynaBeanUtilsTestCase.createDynaClass()
org.apache.commons.beanutils.PropertyUtilsTestCase.testGetSimpleFloat()	org.apache.commons.beanutils.TestBean.getFloatProperty()
org.apache.commons.beanutils.converters.StringArrayConverter.convert(Class,Object)	org.apache.commons.beanutils.converters.AbstractArrayConverter.parseElements(String)
org.apache.commons.beanutils.PropertyUtils.copyProperties(Object,Object)	org.apache.commons.beanutils.PropertyUtils.getSimpleProperty(Object,String)
org.apache.commons.beanutils.BasicDynaBeanTestCase.testGetIndexedArguments()	org.apache.commons.beanutils.DynaBean.get(String,int)
org.apache.commons.beanutils.PropertyUtilsTestCase.testGetReadMethod(Object,String[],String)	org.apache.commons.beanutils.PropertyUtils.getPropertyDescriptors(Object)
org.apache.commons.beanutils.PropertyUtils.getMappedProperty(Object,String,String)	org.apache.commons.beanutils.DynaClass.getDynaProperty(String)
org.apache.commons.beanutils.PropertyUtilsTestCase.testSetNestedString()	org.apache.commons.beanutils.TestBean.getStringProperty()
org.apache.commons.beanutils.DynaBeanUtilsTestCase.testCopyPropertiesStandard()	org.apache.commons.beanutils.TestBean.setIntArray(int[])
org.apache.commons.beanutils.PropertyUtilsTestCase.testSetIndexedValues()	org.apache.commons.beanutils.PropertyUtils.setIndexedProperty(Object,String,Object)
org.apache.commons.beanutils.PropertyUtilsTestCase.testGetWriteMethodPublicSubclass()	org.apache.commons.beanutils.PropertyUtilsTestCase.testGetWriteMethod(Object,String[],String)
org.apache.commons.beanutils.BasicDynaBeanTestCase.testGetSimpleFloat()	org.apache.commons.beanutils.DynaBean.get(String)
org.apache.commons.beanutils.BeanUtilsTestCase.testPopulateScalar()	org.apache.commons.beanutils.TestBean.getFloatProperty()
org.apache.commons.beanutils.DynaPropertyUtilsTestCase.testSetSimpleInt()	org.apache.commons.beanutils.DynaBean.get(String)
org.apache.commons.beanutils.PropertyUtilsTestCase.testGetWriteMethod(Object,String[],String)	org.apache.commons.beanutils.PropertyUtils.getWriteMethod(PropertyDescriptor)
org.apache.commons.beanutils.BasicDynaBeanTestCase.testGetIndexedValues()	org.apache.commons.beanutils.DynaBean.get(String,int)
org.apache.commons.beanutils.PropertyUtilsTestCase.testGetNestedReadOnly()	org.apache.commons.beanutils.TestBean.getReadOnlyProperty()
org.apache.commons.beanutils.BeanUtilsTestCase.testPopulateMapped()	org.apache.commons.beanutils.BeanUtils.populate(Object,Map)
org.apache.commons.beanutils.BasicDynaBean.set(String,String,Object)	org.apache.commons.beanutils.BasicDynaBean.getDynaProperty(String)
org.apache.commons.beanutils.DynaPropertyUtilsTestCase.testGetIndexedValues()	org.apache.commons.beanutils.PropertyUtils.getIndexedProperty(Object,String,int)
org.apache.commons.beanutils.PropertyUtilsTestCase.testGetIndexedValues()	org.apache.commons.beanutils.PropertyUtils.getIndexedProperty(Object,String,int)
org.apache.commons.beanutils.PropertyUtilsTestCase.testSetSimpleInt()	org.apache.commons.beanutils.TestBean.getIntProperty()
org.apache.commons.beanutils.DynaPropertyUtilsTestCase.testSetNestedWriteOnly()	org.apache.commons.beanutils.TestBean.getWriteOnlyPropertyValue()
org.apache.commons.beanutils.DynaPropertyUtilsTestCase.testGetSimpleBoolean()	org.apache.commons.beanutils.PropertyUtils.getSimpleProperty(Object,String)
org.apache.commons.beanutils.MappedPropertyDescriptor.setMappedWriteMethod(Method)	org.apache.commons.beanutils.MappedPropertyDescriptor.findMappedPropertyType()
org.apache.commons.beanutils.DynaPropertyUtilsTestCase.testGetNestedFloat()	org.apache.commons.beanutils.DynaBean.get(String)
org.apache.commons.beanutils.DynaPropertyUtilsTestCase.testSetSimpleShort()	org.apache.commons.beanutils.DynaBean.get(String)
org.apache.commons.beanutils.BeanUtilsTestCase.testPopulateScalar()	org.apache.commons.beanutils.TestBean.getWriteOnlyPropertyValue()
org.apache.commons.beanutils.PropertyUtilsTestCase.testSetSimpleInt()	org.apache.commons.beanutils.PropertyUtils.setSimpleProperty(Object,String,Object)
org.apache.commons.beanutils.DynaPropertyUtilsTestCase.testSetSimpleString()	org.apache.commons.beanutils.DynaBean.get(String)
org.apache.commons.beanutils.PropertyUtilsTestCase.testGetNestedArguments()	org.apache.commons.beanutils.PropertyUtils.getNestedProperty(Object,String)
org.apache.commons.beanutils.DynaBeanUtilsTestCase.testCopyPropertiesDynaBean()	org.apache.commons.beanutils.BeanUtils.copyProperties(Object,Object)
org.apache.commons.beanutils.BeanUtilsTestCase.testCopyPropertiesDynaBean()	org.apache.commons.beanutils.TestBean.getIntArray()
org.apache.commons.beanutils.DynaPropertyUtilsTestCase.testSetSimpleDouble()	org.apache.commons.beanutils.PropertyUtils.setSimpleProperty(Object,String,Object)
org.apache.commons.beanutils.MethodUtils.getAccessibleMethod(Method)	org.apache.commons.beanutils.MethodUtils.getAccessibleMethodFromInterfaceNest(Class,String,Class[])
org.apache.commons.beanutils.DynaPropertyUtilsTestCase.testSetSimpleInt()	org.apache.commons.beanutils.PropertyUtils.setSimpleProperty(Object,String,Object)
org.apache.commons.beanutils.PropertyUtilsTestCase.testSetNestedLong()	org.apache.commons.beanutils.TestBean.getLongProperty()
org.apache.commons.beanutils.BeanUtilsTestCase.testCopyPropertiesDynaBean()	org.apache.commons.beanutils.TestBean.getShortProperty()
org.apache.commons.beanutils.BeanUtilsTestCase.testGetIndexedProperty1()	org.apache.commons.beanutils.TestBean.getIntIndexed(int)
org.apache.commons.beanutils.WrapDynaBean.set(String,String,Object)	org.apache.commons.beanutils.PropertyUtils.setMappedProperty(Object,String,String,Object)
org.apache.commons.beanutils.DynaPropertyUtilsTestCase.testGetNestedDouble()	org.apache.commons.beanutils.DynaBean.get(String)
org.apache.commons.beanutils.BasicDynaBeanTestCase.testSetSimpleDouble()	org.apache.commons.beanutils.DynaBean.set(String,Object)
org.apache.commons.beanutils.DynaBeanUtilsTestCase.testGetIndexedProperty2()	org.apache.commons.beanutils.DynaBean.get(String,int)
org.apache.commons.beanutils.PropertyUtils.describe(Object)	org.apache.commons.beanutils.DynaClass.getDynaProperties()
org.apache.commons.beanutils.BasicDynaBeanTestCase.testGetMappedArguments()	org.apache.commons.beanutils.DynaBean.get(String,String)
org.apache.commons.beanutils.BeanUtils.getProperty(Object,String)	org.apache.commons.beanutils.BeanUtils.getNestedProperty(Object,String)
org.apache.commons.beanutils.BeanUtils.describe(Object)	org.apache.commons.beanutils.DynaProperty.getName()
org.apache.commons.beanutils.PropertyUtilsTestCase.testGetSimpleWriteOnly()	org.apache.commons.beanutils.PropertyUtils.getSimpleProperty(Object,String)
org.apache.commons.beanutils.DynaBeanUtilsTestCase.testPopulateArrayElements()	org.apache.commons.beanutils.BeanUtils.populate(Object,Map)
org.apache.commons.beanutils.DynaPropertyUtilsTestCase.testSetNestedInt()	org.apache.commons.beanutils.PropertyUtils.setNestedProperty(Object,String,Object)
org.apache.commons.beanutils.DynaPropertyUtilsTestCase.testGetNestedBoolean()	org.apache.commons.beanutils.TestBean.getBooleanProperty()
org.apache.commons.beanutils.DynaResultSetTestCase.testIteratorResults()	org.apache.commons.beanutils.DynaBean.get(String)
org.apache.commons.beanutils.DynaBeanUtilsTestCase.testPopulateNested()	org.apache.commons.beanutils.BeanUtils.populate(Object,Map)
org.apache.commons.beanutils.DynaPropertyUtilsTestCase.testGetSimpleString()	org.apache.commons.beanutils.PropertyUtils.getSimpleProperty(Object,String)
org.apache.commons.beanutils.PropertyUtils.getPropertyType(Object,String)	org.apache.commons.beanutils.MappedPropertyDescriptor.getMappedPropertyType()
org.apache.commons.beanutils.BeanUtilsTestCase.testGetIndexedProperty2()	org.apache.commons.beanutils.TestBean.getIntIndexed(int)
org.apache.commons.beanutils.PropertyUtils.getIndexedProperty(Object,String,int)	org.apache.commons.beanutils.DynaBean.getDynaClass()
org.apache.commons.beanutils.DynaResultSetTestCase.testGetName()	org.apache.commons.beanutils.ResultSetDynaClass.getName()
org.apache.commons.beanutils.PropertyUtilsTestCase.testGetNestedBoolean()	org.apache.commons.beanutils.TestBean.getBooleanProperty()
org.apache.commons.beanutils.BeanUtilsTestCase.testCopyPropertiesStandard()	org.apache.commons.beanutils.TestBean.getShortProperty()
org.apache.commons.beanutils.PropertyUtilsTestCase.testSetMappedValues()	org.apache.commons.beanutils.PropertyUtils.setMappedProperty(Object,String,String,Object)
org.apache.commons.beanutils.ResultSetDynaClass.introspect()	org.apache.commons.beanutils.DynaProperty.getName()
org.apache.commons.beanutils.PropertyUtilsTestCase.testGetNestedUnknown()	org.apache.commons.beanutils.PropertyUtils.getNestedProperty(Object,String)
org.apache.commons.beanutils.MappedPropertyDescriptor.internalFindMethod(Class,String,int)	org.apache.commons.beanutils.MappedPropertyDescriptor.internalFindMethod(Class,String,int)
org.apache.commons.beanutils.PropertyUtilsTestCase.testSetIndexedArguments()	org.apache.commons.beanutils.PropertyUtils.setIndexedProperty(Object,String,int,Object)
org.apache.commons.beanutils.PropertyUtilsTestCase.testSetNestedArguments()	org.apache.commons.beanutils.PropertyUtils.setNestedProperty(Object,String,Object)
org.apache.commons.beanutils.DynaPropertyUtilsTestCase.testSetIndexedValues()	org.apache.commons.beanutils.PropertyUtils.setIndexedProperty(Object,String,Object)
org.apache.commons.beanutils.PropertyUtilsTestCase.testSetNestedInt()	org.apache.commons.beanutils.PropertyUtils.setNestedProperty(Object,String,Object)
org.apache.commons.beanutils.DynaPropertyUtilsTestCase.testSetNestedUnknown()	org.apache.commons.beanutils.PropertyUtils.setNestedProperty(Object,String,Object)
org.apache.commons.beanutils.DynaResultSetTestCase.testGetDynaProperty()	org.apache.commons.beanutils.DynaProperty.getType()
org.apache.commons.beanutils.PropertyUtils.getNestedProperty(Object,String)	org.apache.commons.beanutils.PropertyUtils.getMappedProperty(Object,String)
org.apache.commons.beanutils.PropertyUtils.getIndexedProperty(Object,String,int)	org.apache.commons.beanutils.PropertyUtils.getPropertyDescriptor(Object,String)
org.apache.commons.beanutils.PropertyUtils.setIndexedProperty(Object,String,int,Object)	org.apache.commons.beanutils.DynaBean.set(String,int,Object)
org.apache.commons.beanutils.PropertyUtilsTestCase.testGetReadMethodPackageSubclass()	org.apache.commons.beanutils.PropertyUtilsTestCase.testGetReadMethod(Object,String[],String)
org.apache.commons.beanutils.PropertyUtilsTestCase.testGetMappedArguments()	org.apache.commons.beanutils.PropertyUtils.getMappedProperty(Object,String)
org.apache.commons.beanutils.BeanUtils.getIndexedProperty(Object,String,int)	org.apache.commons.beanutils.ConvertUtils.convert(Object)
org.apache.commons.beanutils.MethodUtilsTestCase.testInvokeExactMethod()	org.apache.commons.beanutils.TestBean.getStringProperty()
org.apache.commons.beanutils.PropertyUtils.setNestedProperty(Object,String,Object)	org.apache.commons.beanutils.PropertyUtils.setMappedProperty(Object,String,Object)
org.apache.commons.beanutils.PropertyUtils.setMappedProperty(Object,String,String,Object)	org.apache.commons.beanutils.MappedPropertyDescriptor.getMappedWriteMethod()
org.apache.commons.beanutils.MethodUtilsTestCase.testGetAccessibleMethod()	org.apache.commons.beanutils.priv.PrivateBeanFactory.createSubclass()
org.apache.commons.beanutils.PropertyUtilsTestCase.testGetNestedFloat()	org.apache.commons.beanutils.PropertyUtils.getNestedProperty(Object,String)
org.apache.commons.beanutils.BeanUtilsTestCase.testPopulateScalar()	org.apache.commons.beanutils.TestBean.getStringProperty()
org.apache.commons.beanutils.PropertyUtilsTestCase.testSetSimpleFloat()	org.apache.commons.beanutils.PropertyUtils.setSimpleProperty(Object,String,Object)
org.apache.commons.beanutils.BeanUtils.describe(Object)	org.apache.commons.beanutils.DynaClass.getDynaProperties()
org.apache.commons.beanutils.PropertyUtilsTestCase.testGetNestedBoolean()	org.apache.commons.beanutils.TestBean.getNested()
org.apache.commons.beanutils.PropertyUtilsTestCase.testGetMappedValues()	org.apache.commons.beanutils.PropertyUtils.getMappedProperty(Object,String)
org.apache.commons.beanutils.PropertyUtilsTestCase.testGetDescriptorLong()	org.apache.commons.beanutils.PropertyUtilsTestCase.testGetDescriptorBase(String,String,String)
org.apache.commons.beanutils.ConvertUtilsTestCase.setUp()	org.apache.commons.beanutils.ConvertUtils.deregister()
org.apache.commons.beanutils.PropertyUtilsTestCase.testSetNestedReadOnly()	org.apache.commons.beanutils.TestBean.getWriteOnlyPropertyValue()
org.apache.commons.beanutils.DynaBeanUtilsTestCase.testGetArrayProperty()	org.apache.commons.beanutils.BeanUtils.getArrayProperty(Object,String)
org.apache.commons.beanutils.DynaBeanUtilsTestCase.setUp()	org.apache.commons.beanutils.DynaBeanUtilsTestCase.createDynaClass()
org.apache.commons.beanutils.MethodUtilsTestCase.testInvokeMethod()	org.apache.commons.beanutils.AbstractParent.testAddChild(Child)
org.apache.commons.beanutils.PropertyUtilsTestCase.testSetMappedArguments()	org.apache.commons.beanutils.PropertyUtils.setMappedProperty(Object,String,String,Object)
org.apache.commons.beanutils.PropertyUtils.describe(Object)	org.apache.commons.beanutils.PropertyUtils.getProperty(Object,String)
org.apache.commons.beanutils.BasicDynaBeanTestCase.testGetDescriptorBase(String,Class)	org.apache.commons.beanutils.DynaClass.getDynaProperty(String)
org.apache.commons.beanutils.BasicDynaBeanTestCase.testSetIndexedValues()	org.apache.commons.beanutils.DynaBean.get(String,int)
org.apache.commons.beanutils.DynaBeanUtilsTestCase.testPopulateNested()	org.apache.commons.beanutils.TestBean.getFloatProperty()
org.apache.commons.beanutils.PropertyUtilsTestCase.testGetNestedLong()	org.apache.commons.beanutils.TestBean.getNested()
org.apache.commons.beanutils.BeanUtilsTestCase.testPopulateScalar()	org.apache.commons.beanutils.TestBean.getBooleanProperty()
org.apache.commons.beanutils.BeanUtilsTestCase.testCopyPropertiesStandard()	org.apache.commons.beanutils.TestBean.getIntArray()
org.apache.commons.beanutils.PropertyUtils.getReadMethod(PropertyDescriptor)	org.apache.commons.beanutils.MethodUtils.getAccessibleMethod(Method)
org.apache.commons.beanutils.PropertyUtilsTestCase.testSetSimpleReadOnly()	org.apache.commons.beanutils.TestBean.getWriteOnlyPropertyValue()
org.apache.commons.beanutils.BeanUtilsTestCase.testPopulateNested()	org.apache.commons.beanutils.TestBean.getWriteOnlyPropertyValue()
org.apache.commons.beanutils.DynaBeanUtilsTestCase.testGetIndexedProperty1()	org.apache.commons.beanutils.DynaBean.get(String,int)
org.apache.commons.beanutils.converters.BooleanArrayConverter.convert(Class,Object)	org.apache.commons.beanutils.converters.AbstractArrayConverter.parseElements(String)
org.apache.commons.beanutils.BeanUtils.copyProperty(Object,String,Object)	org.apache.commons.beanutils.ConvertUtils.lookup(Class)
org.apache.commons.beanutils.BeanUtils.setProperty(Object,String,Object)	org.apache.commons.beanutils.MappedPropertyDescriptor.getMappedWriteMethod()
org.apache.commons.beanutils.DynaPropertyUtilsTestCase.testGetNestedBoolean()	org.apache.commons.beanutils.DynaBean.get(String)
org.apache.commons.beanutils.DynaPropertyUtilsTestCase.testGetNestedFloat()	org.apache.commons.beanutils.PropertyUtils.getNestedProperty(Object,String)
org.apache.commons.beanutils.PropertyUtilsTestCase.testSetSimpleArguments()	org.apache.commons.beanutils.PropertyUtils.setSimpleProperty(Object,String,Object)
org.apache.commons.beanutils.ConvertUtilsTestCase.testNegativeIntegerArray()	org.apache.commons.beanutils.ConvertUtilsTestCase.checkIntegerArray(Object,int[])
org.apache.commons.beanutils.PropertyUtilsTestCase.testGetSimpleLong()	org.apache.commons.beanutils.PropertyUtils.getSimpleProperty(Object,String)
org.apache.commons.beanutils.PropertyUtils.getNestedProperty(Object,String)	org.apache.commons.beanutils.PropertyUtils.getIndexedProperty(Object,String)
org.apache.commons.beanutils.MappedPropertyDescriptor.internalFindMethod(Class,String,int)	org.apache.commons.beanutils.MappedPropertyDescriptor.getPublicDeclaredMethods(Class)
org.apache.commons.beanutils.DynaPropertyUtilsTestCase.testSetNestedShort()	org.apache.commons.beanutils.PropertyUtils.setNestedProperty(Object,String,Object)
org.apache.commons.beanutils.MethodUtils.invokeExactMethod(Object,String,Object[],Class[])	org.apache.commons.beanutils.MethodUtils.getAccessibleMethod(Class,String,Class[])
org.apache.commons.beanutils.DynaBeanUtilsTestCase.testDescribe()	org.apache.commons.beanutils.PropertyUtils.describe(Object)
org.apache.commons.beanutils.PropertyUtilsTestCase.testGetNestedShort()	org.apache.commons.beanutils.TestBean.getNested()
org.apache.commons.beanutils.PropertyUtilsTestCase.testGetSimpleString()	org.apache.commons.beanutils.TestBean.getStringProperty()
org.apache.commons.beanutils.PropertyUtilsTestCase.testSetNestedShort()	org.apache.commons.beanutils.TestBean.getNested()
org.apache.commons.beanutils.PropertyUtils.getIndexedProperty(Object,String,int)	org.apache.commons.beanutils.DynaBean.get(String,int)
org.apache.commons.beanutils.PropertyUtilsTestCase.testSetSimpleBoolean()	org.apache.commons.beanutils.TestBean.getBooleanProperty()
org.apache.commons.beanutils.PropertyUtilsTestCase.testGetDescriptorBase(String,String,String)	org.apache.commons.beanutils.PropertyUtils.getPropertyDescriptor(Object,String)
org.apache.commons.beanutils.PropertyUtilsTestCase.testSetSimpleReadOnly()	org.apache.commons.beanutils.PropertyUtils.setSimpleProperty(Object,String,Object)
org.apache.commons.beanutils.DynaBeanUtilsTestCase.testPopulateScalar()	org.apache.commons.beanutils.BeanUtils.populate(Object,Map)
org.apache.commons.beanutils.BeanUtilsTestCase.testCopyPropertiesStandard()	org.apache.commons.beanutils.TestBean.setIntArray(int[])
org.apache.commons.beanutils.BeanUtils.setProperty(Object,String,Object)	org.apache.commons.beanutils.ConvertUtils.convert(String[],Class)
org.apache.commons.beanutils.PropertyUtilsTestCase.testGetSimpleShort()	org.apache.commons.beanutils.TestBean.getShortProperty()
org.apache.commons.beanutils.DynaPropertyUtilsTestCase.testSetSimpleUnknown()	org.apache.commons.beanutils.PropertyUtils.setSimpleProperty(Object,String,Object)
org.apache.commons.beanutils.PropertyUtilsTestCase.testSetSimpleUnknown()	org.apache.commons.beanutils.PropertyUtils.setSimpleProperty(Object,String,Object)
org.apache.commons.beanutils.PropertyUtils.copyProperties(Object,Object)	org.apache.commons.beanutils.DynaProperty.getName()
org.apache.commons.beanutils.BeanUtils.copyProperties(Object,Object)	org.apache.commons.beanutils.DynaBean.get(String)
org.apache.commons.beanutils.converters.ByteArrayConverter.convert(Class,Object)	org.apache.commons.beanutils.converters.AbstractArrayConverter.parseElements(String)
org.apache.commons.beanutils.PropertyUtilsTestCase.testSetNestedUnknown()	org.apache.commons.beanutils.PropertyUtils.setNestedProperty(Object,String,Object)
org.apache.commons.beanutils.BeanUtils.getNestedProperty(Object,String)	org.apache.commons.beanutils.ConvertUtils.convert(Object)
org.apache.commons.beanutils.PropertyUtilsTestCase.testGetSimpleNested()	org.apache.commons.beanutils.PropertyUtils.getSimpleProperty(Object,String)
org.apache.commons.beanutils.MethodUtils.invokeExactMethod(Object,String,Object[])	org.apache.commons.beanutils.MethodUtils.invokeExactMethod(Object,String,Object[],Class[])
org.apache.commons.beanutils.DynaPropertyUtilsTestCase.testSetMappedValues()	org.apache.commons.beanutils.PropertyUtils.setNestedProperty(Object,String,Object)
org.apache.commons.beanutils.PropertyUtilsTestCase.testSetNestedInt()	org.apache.commons.beanutils.TestBean.getNested()
org.apache.commons.beanutils.PropertyUtilsTestCase.testGetReadMethodPublicInterface()	org.apache.commons.beanutils.PropertyUtilsTestCase.testGetReadMethod(Object,String[],String)
org.apache.commons.beanutils.PropertyUtils.setSimpleProperty(Object,String,Object)	org.apache.commons.beanutils.DynaBean.getDynaClass()
org.apache.commons.beanutils.BeanUtils.setProperty(Object,String,Object)	org.apache.commons.beanutils.PropertyUtils.getProperty(Object,String)
org.apache.commons.beanutils.DynaPropertyUtilsTestCase.testGetNestedString()	org.apache.commons.beanutils.PropertyUtils.getNestedProperty(Object,String)
org.apache.commons.beanutils.PropertyUtilsTestCase.testGetNestedInt()	org.apache.commons.beanutils.PropertyUtils.getNestedProperty(Object,String)
org.apache.commons.beanutils.BeanUtils.copyProperties(Object,Object)	org.apache.commons.beanutils.DynaBean.getDynaClass()
org.apache.commons.beanutils.ResultSetIterator.next()	org.apache.commons.beanutils.ResultSetIterator.advance()
org.apache.commons.beanutils.BasicDynaBeanTestCase.testGetDescriptors()	org.apache.commons.beanutils.DynaBean.getDynaClass()
org.apache.commons.beanutils.BasicDynaBeanTestCase.testMappedRemove()	org.apache.commons.beanutils.DynaBean.remove(String,String)
org.apache.commons.beanutils.BeanUtils.copyProperties(Object,Object)	org.apache.commons.beanutils.PropertyUtils.getSimpleProperty(Object,String)
org.apache.commons.beanutils.PropertyUtils.setNestedProperty(Object,String,Object)	org.apache.commons.beanutils.PropertyUtils.getMappedProperty(Object,String)
org.apache.commons.beanutils.MethodUtilsTestCase.testInvokeMethod()	org.apache.commons.beanutils.MethodUtils.invokeMethod(Object,String,Object[])
org.apache.commons.beanutils.PropertyUtils.setNestedProperty(Object,String,Object)	org.apache.commons.beanutils.PropertyUtils.getIndexedProperty(Object,String)
org.apache.commons.beanutils.AbstractParent.testAddChild2(String,Child)	org.apache.commons.beanutils.Child.getName()
org.apache.commons.beanutils.BeanUtilsTestCase.testPopulateScalar()	org.apache.commons.beanutils.BeanUtils.populate(Object,Map)
org.apache.commons.beanutils.PropertyUtilsTestCase.testSetSimpleShort()	org.apache.commons.beanutils.TestBean.getShortProperty()
org.apache.commons.beanutils.BeanUtilsTestCase.testGetSimpleProperty()	org.apache.commons.beanutils.TestBean.getShortProperty()
org.apache.commons.beanutils.ResultSetIterator.get(String)	org.apache.commons.beanutils.ResultSetDynaClass.getResultSet()
org.apache.commons.beanutils.DynaBeanUtilsTestCase.testPopulateNested()	org.apache.commons.beanutils.TestBean.getIntProperty()
org.apache.commons.beanutils.DynaPropertyUtilsTestCase.testGetSimpleLong()	org.apache.commons.beanutils.PropertyUtils.getSimpleProperty(Object,String)
org.apache.commons.beanutils.BeanUtilsTestCase.testGetArrayProperty()	org.apache.commons.beanutils.BeanUtils.getArrayProperty(Object,String)
org.apache.commons.beanutils.converters.IntegerArrayConverter.convert(Class,Object)	org.apache.commons.beanutils.converters.AbstractArrayConverter.parseElements(String)
org.apache.commons.beanutils.PropertyUtils.getPropertyType(Object,String)	org.apache.commons.beanutils.DynaBean.getDynaClass()
org.apache.commons.beanutils.PropertyUtils.getSimpleProperty(Object,String)	org.apache.commons.beanutils.PropertyUtils.getReadMethod(PropertyDescriptor)
org.apache.commons.beanutils.WrapDynaClass.introspect()	org.apache.commons.beanutils.DynaProperty.getName()
org.apache.commons.beanutils.BeanUtilsTestCase.testPopulateArrayProperties()	org.apache.commons.beanutils.TestBean.getIntArray()
org.apache.commons.beanutils.BeanUtilsTestCase.testCopyPropertiesDynaBean()	org.apache.commons.beanutils.TestBean.getStringArray()
org.apache.commons.beanutils.DynaBeanUtilsTestCase.setUp()	org.apache.commons.beanutils.DynaBean.set(String,Object)
org.apache.commons.beanutils.DynaPropertyUtilsTestCase.testGetSimpleShort()	org.apache.commons.beanutils.PropertyUtils.getSimpleProperty(Object,String)
org.apache.commons.beanutils.DynaResultSetTestCase.testGetDynaProperties()	org.apache.commons.beanutils.DynaProperty.getName()
org.apache.commons.beanutils.PropertyUtilsTestCase.testGetWriteMethodPackageSubclass()	org.apache.commons.beanutils.PropertyUtilsTestCase.testGetWriteMethod(Object,String[],String)
org.apache.commons.beanutils.BasicDynaBean.get(String,String)	org.apache.commons.beanutils.BasicDynaBean.getDynaProperty(String)
org.apache.commons.beanutils.BeanUtils.copyProperty(Object,String,Object)	org.apache.commons.beanutils.DynaBean.getDynaClass()
org.apache.commons.beanutils.BeanUtilsTestCase.testPopulateNested()	org.apache.commons.beanutils.TestBean.getIntProperty()
org.apache.commons.beanutils.DynaBeanUtilsTestCase.testCopyPropertiesStandard()	org.apache.commons.beanutils.TestBean.setIntProperty(int)
org.apache.commons.beanutils.DynaPropertyUtilsTestCase.testSetNestedWriteOnly()	org.apache.commons.beanutils.PropertyUtils.setNestedProperty(Object,String,Object)
org.apache.commons.beanutils.PropertyUtils.getPropertyEditorClass(Object,String)	org.apache.commons.beanutils.PropertyUtils.getPropertyDescriptor(Object,String)
org.apache.commons.beanutils.MethodUtils.invokeMethod(Object,String,Object)	org.apache.commons.beanutils.MethodUtils.invokeMethod(Object,String,Object[])
org.apache.commons.beanutils.BeanUtilsTestCase.testPopulateNested()	org.apache.commons.beanutils.TestBean.getNested()
org.apache.commons.beanutils.BeanUtilsTestCase.testCopyPropertiesStandard()	org.apache.commons.beanutils.TestBean.getLongProperty()
org.apache.commons.beanutils.BeanUtilsTestCase.testCopyPropertiesStandard()	org.apache.commons.beanutils.BeanUtils.copyProperties(Object,Object)
org.apache.commons.beanutils.BeanUtilsTestCase.testGetSimpleProperty()	org.apache.commons.beanutils.BeanUtils.getSimpleProperty(Object,String)
org.apache.commons.beanutils.ResultSetIterator.get(String)	org.apache.commons.beanutils.ResultSetDynaClass.getDynaProperty(String)
org.apache.commons.beanutils.BeanUtilsTestCase.testGetIndexedProperty1()	org.apache.commons.beanutils.TestBean.getStringIndexed(int)
org.apache.commons.beanutils.PropertyUtils.setIndexedProperty(Object,String,Object)	org.apache.commons.beanutils.PropertyUtils.setIndexedProperty(Object,String,int,Object)
org.apache.commons.beanutils.PropertyUtils.setSimpleProperty(Object,String,Object)	org.apache.commons.beanutils.DynaBean.set(String,Object)
org.apache.commons.beanutils.BeanUtilsTestCase.testCopyPropertiesStandard()	org.apache.commons.beanutils.TestBean.setStringProperty(String)
org.apache.commons.beanutils.DynaPropertyUtilsTestCase.testSetSimpleDouble()	org.apache.commons.beanutils.DynaBean.get(String)
org.apache.commons.beanutils.PropertyUtilsTestCase.testGetSimpleFloat()	org.apache.commons.beanutils.PropertyUtils.getSimpleProperty(Object,String)
org.apache.commons.beanutils.BasicDynaBeanTestCase.testGetSimpleDouble()	org.apache.commons.beanutils.DynaBean.get(String)
org.apache.commons.beanutils.DynaPropertyUtilsTestCase.testGetIndexedArguments()	org.apache.commons.beanutils.PropertyUtils.getIndexedProperty(Object,String)
org.apache.commons.beanutils.DynaPropertyUtilsTestCase.testSetNestedDouble()	org.apache.commons.beanutils.PropertyUtils.setNestedProperty(Object,String,Object)
org.apache.commons.beanutils.BeanUtils.getNestedProperty(Object,String)	org.apache.commons.beanutils.PropertyUtils.getNestedProperty(Object,String)
org.apache.commons.beanutils.PropertyUtilsTestCase.testSetMappedArguments()	org.apache.commons.beanutils.PropertyUtils.setMappedProperty(Object,String,Object)
org.apache.commons.beanutils.MappedPropertyDescriptor.findMethod(Class,String,int,Class[])	org.apache.commons.beanutils.MappedPropertyDescriptor.internalFindMethod(Class,String,int,Class[])
org.apache.commons.beanutils.BeanUtilsTestCase.testPopulateArrayElements()	org.apache.commons.beanutils.TestBean.getStringIndexed(int)
org.apache.commons.beanutils.DynaPropertyUtilsTestCase.testGetIndexedArguments()	org.apache.commons.beanutils.PropertyUtils.getIndexedProperty(Object,String,int)
org.apache.commons.beanutils.BasicDynaBeanTestCase.testSetSimpleShort()	org.apache.commons.beanutils.DynaBean.set(String,Object)
org.apache.commons.beanutils.PropertyUtilsTestCase.setUp()	org.apache.commons.beanutils.priv.PrivateBeanFactory.create()
org.apache.commons.beanutils.PropertyUtilsTestCase.testGetIndexedArguments()	org.apache.commons.beanutils.PropertyUtils.getIndexedProperty(Object,String,int)
org.apache.commons.beanutils.PropertyUtilsTestCase.testSetNestedFloat()	org.apache.commons.beanutils.TestBean.getFloatProperty()
org.apache.commons.beanutils.MappedPropertyDescriptor.findMethod(Class,String,int)	org.apache.commons.beanutils.MappedPropertyDescriptor.internalFindMethod(Class,String,int)
org.apache.commons.beanutils.DynaBeanUtilsTestCase.setUp()	org.apache.commons.beanutils.DynaClass.newInstance()
org.apache.commons.beanutils.DynaPropertyUtilsTestCase.testGetNestedString()	org.apache.commons.beanutils.DynaBean.get(String)
org.apache.commons.beanutils.PropertyUtilsTestCase.testSetNestedInt()	org.apache.commons.beanutils.TestBean.getIntProperty()
org.apache.commons.beanutils.DynaPropertyUtilsTestCase.testGetNestedReadOnly()	org.apache.commons.beanutils.PropertyUtils.getNestedProperty(Object,String)
org.apache.commons.beanutils.PropertyUtils.setMappedProperty(Object,String,String,Object)	org.apache.commons.beanutils.DynaClass.getDynaProperty(String)
org.apache.commons.beanutils.PropertyUtilsTestCase.testSetMappedValues()	org.apache.commons.beanutils.PropertyUtils.getMappedProperty(Object,String)
org.apache.commons.beanutils.DynaBeanUtilsTestCase.testPopulateMapped()	org.apache.commons.beanutils.BeanUtils.populate(Object,Map)
org.apache.commons.beanutils.PropertyUtils.setMappedProperty(Object,String,String,Object)	org.apache.commons.beanutils.PropertyUtils.getPropertyDescriptor(Object,String)
org.apache.commons.beanutils.PropertyUtilsTestCase.testGetNestedFloat()	org.apache.commons.beanutils.TestBean.getFloatProperty()
org.apache.commons.beanutils.MethodUtilsTestCase.testInvokeExactMethod()	org.apache.commons.beanutils.MethodUtils.invokeExactMethod(Object,String,Object)
org.apache.commons.beanutils.DynaBeanUtilsTestCase.testCopyPropertiesStandard()	org.apache.commons.beanutils.TestBean.setStringArray(String[])
org.apache.commons.beanutils.BasicDynaBeanTestCase.testGetDescriptorFloat()	org.apache.commons.beanutils.BasicDynaBeanTestCase.testGetDescriptorBase(String,Class)
org.apache.commons.beanutils.WrapDynaBeanTestCase.testMappedRemove()	org.apache.commons.beanutils.DynaBean.contains(String,String)
org.apache.commons.beanutils.PropertyUtils.setProperty(Object,String,Object)	org.apache.commons.beanutils.PropertyUtils.setNestedProperty(Object,String,Object)
org.apache.commons.beanutils.PropertyUtilsTestCase.testGetNestedBoolean()	org.apache.commons.beanutils.PropertyUtils.getNestedProperty(Object,String)
org.apache.commons.beanutils.PropertyUtilsTestCase.testGetSimpleIndexed()	org.apache.commons.beanutils.PropertyUtils.getSimpleProperty(Object,String)
org.apache.commons.beanutils.DynaPropertyUtilsTestCase.testGetSimpleIndexed()	org.apache.commons.beanutils.PropertyUtils.getSimpleProperty(Object,String)
org.apache.commons.beanutils.PropertyUtilsTestCase.testGetNestedWriteOnly()	org.apache.commons.beanutils.PropertyUtils.getNestedProperty(Object,String)
org.apache.commons.beanutils.PropertyUtils.getSimpleProperty(Object,String)	org.apache.commons.beanutils.DynaBean.get(String)
org.apache.commons.beanutils.BeanUtils.describe(Object)	org.apache.commons.beanutils.BeanUtils.getProperty(Object,String)
org.apache.commons.beanutils.PropertyUtilsTestCase.testSetNestedBoolean()	org.apache.commons.beanutils.PropertyUtils.setNestedProperty(Object,String,Object)
org.apache.commons.beanutils.BeanUtils.setProperty(Object,String,Object)	org.apache.commons.beanutils.PropertyUtils.setProperty(Object,String,Object)
org.apache.commons.beanutils.BeanUtilsTestCase.testGetNestedProperty()	org.apache.commons.beanutils.TestBean.getStringProperty()
org.apache.commons.beanutils.PropertyUtilsTestCase.testGetNestedReadOnly()	org.apache.commons.beanutils.PropertyUtils.getNestedProperty(Object,String)
org.apache.commons.beanutils.PropertyUtils.getMappedPropertyDescriptors(Object)	org.apache.commons.beanutils.PropertyUtils.getMappedPropertyDescriptors(Class)
org.apache.commons.beanutils.BeanUtilsTestCase.testPopulateNested()	org.apache.commons.beanutils.TestBean.getLongProperty()
org.apache.commons.beanutils.BeanUtilsTestCase.testPopulateScalar()	org.apache.commons.beanutils.TestBean.getIntProperty()
org.apache.commons.beanutils.BasicDynaBeanTestCase.testGetDescriptorArguments()	org.apache.commons.beanutils.DynaBean.getDynaClass()
org.apache.commons.beanutils.DynaPropertyUtilsTestCase.testGetSimpleInt()	org.apache.commons.beanutils.PropertyUtils.getSimpleProperty(Object,String)
org.apache.commons.beanutils.BeanUtilsTestCase.testCopyPropertiesDynaBean()	org.apache.commons.beanutils.TestBean.getDoubleProperty()
org.apache.commons.beanutils.BeanUtilsTestCase.testPopulateScalar()	org.apache.commons.beanutils.TestBean.getShortProperty()
org.apache.commons.beanutils.DynaBeanUtilsTestCase.testPopulateNested()	org.apache.commons.beanutils.DynaBean.get(String)
org.apache.commons.beanutils.WrapDynaBean.set(String,int,Object)	org.apache.commons.beanutils.PropertyUtils.setIndexedProperty(Object,String,int,Object)
org.apache.commons.beanutils.PropertyUtilsTestCase.testGetNestedString()	org.apache.commons.beanutils.TestBean.getNested()
org.apache.commons.beanutils.DynaPropertyUtilsTestCase.testGetMappedValues()	org.apache.commons.beanutils.PropertyUtils.getMappedProperty(Object,String,String)
org.apache.commons.beanutils.PropertyUtilsTestCase.testSetNestedBoolean()	org.apache.commons.beanutils.TestBean.getBooleanProperty()
org.apache.commons.beanutils.BasicDynaBeanTestCase.testSetSimpleInt()	org.apache.commons.beanutils.DynaBean.set(String,Object)
org.apache.commons.beanutils.DynaPropertyUtilsTestCase.testSetSimpleNested()	org.apache.commons.beanutils.PropertyUtils.setSimpleProperty(Object,String,Object)
org.apache.commons.beanutils.DynaPropertyUtilsTestCase.testSetSimpleLong()	org.apache.commons.beanutils.DynaBean.get(String)
org.apache.commons.beanutils.DynaPropertyUtilsTestCase.testSetNestedReadOnly()	org.apache.commons.beanutils.PropertyUtils.setNestedProperty(Object,String,Object)
org.apache.commons.beanutils.PropertyUtilsTestCase.testGetWriteMethod(Object,String[],String)	org.apache.commons.beanutils.PropertyUtils.getPropertyDescriptors(Object)
org.apache.commons.beanutils.PropertyUtils.copyProperties(Object,Object)	org.apache.commons.beanutils.DynaClass.getDynaProperties()
org.apache.commons.beanutils.BasicDynaBean.getDynaProperty(String)	org.apache.commons.beanutils.BasicDynaBean.getDynaClass()
org.apache.commons.beanutils.BeanUtilsTestCase.testCopyPropertiesDynaBean()	org.apache.commons.beanutils.BeanUtils.copyProperties(Object,Object)
org.apache.commons.beanutils.PropertyUtilsTestCase.testSetNestedFloat()	org.apache.commons.beanutils.PropertyUtils.setNestedProperty(Object,String,Object)
org.apache.commons.beanutils.DynaPropertyUtilsTestCase.testSetNestedInt()	org.apache.commons.beanutils.TestBean.getIntProperty()
org.apache.commons.beanutils.PropertyUtilsTestCase.testSetNestedReadOnly()	org.apache.commons.beanutils.TestBean.getNested()
org.apache.commons.beanutils.DynaPropertyUtilsTestCase.testSetIndexedValues()	org.apache.commons.beanutils.PropertyUtils.setIndexedProperty(Object,String,int,Object)
org.apache.commons.beanutils.PropertyUtils.describe(Object)	org.apache.commons.beanutils.DynaBean.getDynaClass()
org.apache.commons.beanutils.PropertyUtils.getPropertyDescriptor(Object,String)	org.apache.commons.beanutils.PropertyUtils.getMappedPropertyDescriptors(Object)
org.apache.commons.beanutils.DynaPropertyUtilsTestCase.testSetIndexedArguments()	org.apache.commons.beanutils.PropertyUtils.setIndexedProperty(Object,String,int,Object)
org.apache.commons.beanutils.PropertyUtilsTestCase.testSetSimpleWriteOnly()	org.apache.commons.beanutils.PropertyUtils.setSimpleProperty(Object,String,Object)
org.apache.commons.beanutils.BeanUtilsTestCase.testPopulateNested()	org.apache.commons.beanutils.TestBean.getFloatProperty()
org.apache.commons.beanutils.DynaPropertyUtilsTestCase.testSetSimpleShort()	org.apache.commons.beanutils.PropertyUtils.setSimpleProperty(Object,String,Object)
org.apache.commons.beanutils.PropertyUtilsTestCase.testGetSimpleLong()	org.apache.commons.beanutils.TestBean.getLongProperty()
org.apache.commons.beanutils.PropertyUtilsTestCase.testSetNestedBoolean()	org.apache.commons.beanutils.TestBean.getNested()
org.apache.commons.beanutils.DynaBeanUtilsTestCase.testCopyPropertiesStandard()	org.apache.commons.beanutils.TestBean.setStringProperty(String)
org.apache.commons.beanutils.WrapDynaBean.get(String,int)	org.apache.commons.beanutils.PropertyUtils.getIndexedProperty(Object,String,int)
org.apache.commons.beanutils.BasicDynaBean.contains(String,String)	org.apache.commons.beanutils.BasicDynaBean.getDynaProperty(String)
org.apache.commons.beanutils.BasicDynaBeanTestCase.testGetDescriptorArguments()	org.apache.commons.beanutils.DynaClass.getDynaProperty(String)
org.apache.commons.beanutils.PropertyUtilsTestCase.testSetNestedFloat()	org.apache.commons.beanutils.TestBean.getNested()
org.apache.commons.beanutils.PropertyUtilsTestCase.testSetNestedReadOnly()	org.apache.commons.beanutils.PropertyUtils.setNestedProperty(Object,String,Object)
org.apache.commons.beanutils.DynaResultSetTestCase.testNewInstance()	org.apache.commons.beanutils.ResultSetDynaClass.newInstance()
org.apache.commons.beanutils.PropertyUtilsTestCase.testGetNestedString()	org.apache.commons.beanutils.PropertyUtils.getNestedProperty(Object,String)
org.apache.commons.beanutils.BeanUtils.getMappedProperty(Object,String)	org.apache.commons.beanutils.ConvertUtils.convert(Object)
org.apache.commons.beanutils.PropertyUtilsTestCase.testGetDescriptorUnknown()	org.apache.commons.beanutils.PropertyUtilsTestCase.testGetDescriptorBase(String,String,String)
org.apache.commons.beanutils.BasicDynaBeanTestCase.testSetSimpleShort()	org.apache.commons.beanutils.DynaBean.get(String)
org.apache.commons.beanutils.DynaPropertyUtilsTestCase.testGetSimpleNested()	org.apache.commons.beanutils.PropertyUtils.getSimpleProperty(Object,String)
org.apache.commons.beanutils.priv.PrivateBeanSubclass.getBar()	org.apache.commons.beanutils.priv.PrivateBean.getBar()
org.apache.commons.beanutils.BeanUtils.copyProperty(Object,String,Object)	org.apache.commons.beanutils.PropertyUtils.getPropertyDescriptor(Object,String)
org.apache.commons.beanutils.DynaBeanUtilsTestCase.testCopyPropertiesStandard()	org.apache.commons.beanutils.BeanUtils.copyProperties(Object,Object)
org.apache.commons.beanutils.PropertyUtilsTestCase.testSetSimpleWriteOnly()	org.apache.commons.beanutils.TestBean.getWriteOnlyPropertyValue()
org.apache.commons.beanutils.ConvertUtilsTestCase.testPositiveIntegerArray()	org.apache.commons.beanutils.ConvertUtilsTestCase.checkIntegerArray(Object,int[])
org.apache.commons.beanutils.DynaPropertyUtilsTestCase.testSetNestedLong()	org.apache.commons.beanutils.TestBean.getLongProperty()
org.apache.commons.beanutils.PropertyUtilsTestCase.testSetMappedValues()	org.apache.commons.beanutils.PropertyUtils.setNestedProperty(Object,String,Object)
org.apache.commons.beanutils.PropertyUtils.setMappedProperty(Object,String,String,Object)	org.apache.commons.beanutils.DynaBean.getDynaClass()
org.apache.commons.beanutils.BeanUtilsTestCase.testPopulateNested()	org.apache.commons.beanutils.BeanUtils.populate(Object,Map)
org.apache.commons.beanutils.DynaPropertyUtilsTestCase.testGetNestedLong()	org.apache.commons.beanutils.DynaBean.get(String)
org.apache.commons.beanutils.DynaBeanUtilsTestCase.testGetGeneralProperty()	org.apache.commons.beanutils.DynaBean.get(String,int)
org.apache.commons.beanutils.BeanUtilsTestCase.testPopulateNested()	org.apache.commons.beanutils.TestBean.getStringProperty()
org.apache.commons.beanutils.DynaPropertyUtilsTestCase.testGetNestedArguments()	org.apache.commons.beanutils.PropertyUtils.getNestedProperty(Object,String)
org.apache.commons.beanutils.PropertyUtilsTestCase.testSetNestedWriteOnly()	org.apache.commons.beanutils.TestBean.getWriteOnlyPropertyValue()
org.apache.commons.beanutils.PropertyUtils.getPropertyDescriptor(Object,String)	org.apache.commons.beanutils.PropertyUtils.getSimpleProperty(Object,String)
org.apache.commons.beanutils.BasicDynaBean.set(String,int,Object)	org.apache.commons.beanutils.BasicDynaBean.getDynaProperty(String)
org.apache.commons.beanutils.PropertyUtilsTestCase.testGetDescriptorString()	org.apache.commons.beanutils.PropertyUtilsTestCase.testGetDescriptorBase(String,String,String)
org.apache.commons.beanutils.BeanUtils.setProperty(Object,String,Object)	org.apache.commons.beanutils.ConvertUtils.convert(String,Class)
org.apache.commons.beanutils.BasicDynaBeanTestCase.testGetSimpleShort()	org.apache.commons.beanutils.DynaBean.get(String)
org.apache.commons.beanutils.WrapDynaBeanTestCase.testMappedContains()	org.apache.commons.beanutils.DynaBean.contains(String,String)
org.apache.commons.beanutils.BeanUtilsTestCase.testPopulateArrayProperties()	org.apache.commons.beanutils.TestBean.getStringArray()
org.apache.commons.beanutils.BeanUtilsTestCase.testGetIndexedProperty2()	org.apache.commons.beanutils.TestBean.getStringIndexed(int)
org.apache.commons.beanutils.PropertyUtilsTestCase.testGetReadMethodPublicSubclass()	org.apache.commons.beanutils.PropertyUtilsTestCase.testGetReadMethod(Object,String[],String)
org.apache.commons.beanutils.PropertyUtilsTestCase.testGetDescriptorReadOnly()	org.apache.commons.beanutils.PropertyUtilsTestCase.testGetDescriptorBase(String,String,String)
org.apache.commons.beanutils.BeanUtils.populate(Object,Map)	org.apache.commons.beanutils.BeanUtils.setProperty(Object,String,Object)
org.apache.commons.beanutils.DynaPropertyUtilsTestCase.testSetNestedLong()	org.apache.commons.beanutils.PropertyUtils.setNestedProperty(Object,String,Object)
org.apache.commons.beanutils.DynaBeanUtilsTestCase.testPopulateMapped()	org.apache.commons.beanutils.DynaBean.get(String,String)
org.apache.commons.beanutils.PropertyUtilsTestCase.testGetSimpleInt()	org.apache.commons.beanutils.PropertyUtils.getSimpleProperty(Object,String)
org.apache.commons.beanutils.BasicDynaBeanTestCase.testGetSimpleArguments()	org.apache.commons.beanutils.DynaBean.get(String)
org.apache.commons.beanutils.DynaPropertyUtilsTestCase.testSetNestedBoolean()	org.apache.commons.beanutils.TestBean.getBooleanProperty()
org.apache.commons.beanutils.PropertyUtilsTestCase.testGetNestedFloat()	org.apache.commons.beanutils.TestBean.getNested()
org.apache.commons.beanutils.PropertyUtilsTestCase.testGetNestedString()	org.apache.commons.beanutils.TestBean.getStringProperty()
org.apache.commons.beanutils.PropertyUtilsTestCase.testGetDescriptorDouble()	org.apache.commons.beanutils.PropertyUtilsTestCase.testGetDescriptorBase(String,String,String)
org.apache.commons.beanutils.BeanUtilsTestCase.testCopyPropertiesStandard()	org.apache.commons.beanutils.TestBean.setShortProperty(short)
org.apache.commons.beanutils.BeanUtilsTestCase.testGetIndexedProperty2()	org.apache.commons.beanutils.BeanUtils.getIndexedProperty(Object,String,int)
org.apache.commons.beanutils.BeanUtils.getIndexedProperty(Object,String,int)	org.apache.commons.beanutils.PropertyUtils.getIndexedProperty(Object,String,int)
org.apache.commons.beanutils.WrapDynaBean.get(String)	org.apache.commons.beanutils.PropertyUtils.getSimpleProperty(Object,String)
org.apache.commons.beanutils.AbstractParent.testAddChild(Child)	org.apache.commons.beanutils.Child.getName()
org.apache.commons.beanutils.BeanUtilsTestCase.testGetArrayProperty()	org.apache.commons.beanutils.TestBean.getIntArray()
org.apache.commons.beanutils.DynaPropertyUtilsTestCase.testGetSimpleDouble()	org.apache.commons.beanutils.PropertyUtils.getSimpleProperty(Object,String)
org.apache.commons.beanutils.PropertyUtilsTestCase.testGetReadMethodPublicInterface()	org.apache.commons.beanutils.PropertyUtils.getPropertyDescriptors(Object)
org.apache.commons.beanutils.DynaPropertyUtilsTestCase.testGetNestedBoolean()	org.apache.commons.beanutils.PropertyUtils.getNestedProperty(Object,String)
org.apache.commons.beanutils.BeanUtils.setProperty(Object,String,Object)	org.apache.commons.beanutils.MappedPropertyDescriptor.getMappedPropertyType()
org.apache.commons.beanutils.PropertyUtilsTestCase.testGetNestedDouble()	org.apache.commons.beanutils.TestBean.getNested()
org.apache.commons.beanutils.PropertyUtilsTestCase.testSetSimpleLong()	org.apache.commons.beanutils.TestBean.getLongProperty()
org.apache.commons.beanutils.BeanUtilsTestCase.testCopyPropertiesStandard()	org.apache.commons.beanutils.TestBean.getDoubleProperty()
org.apache.commons.beanutils.ConvertUtilsTestCase.testNegativeStringArray()	org.apache.commons.beanutils.ConvertUtils.convert(String,Class)
org.apache.commons.beanutils.PropertyUtilsTestCase.testMappedPropertyType()	org.apache.commons.beanutils.PropertyUtils.getPropertyDescriptor(Object,String)
org.apache.commons.beanutils.BeanUtilsTestCase.testPopulateNested()	org.apache.commons.beanutils.TestBean.getBooleanProperty()
org.apache.commons.beanutils.DynaResultSetTestCase.testGetDynaProperty()	org.apache.commons.beanutils.DynaProperty.getName()
org.apache.commons.beanutils.MethodUtilsTestCase.testGetAccessibleMethod()	org.apache.commons.beanutils.MethodUtils.getAccessibleMethod(Class,String,Class)
org.apache.commons.beanutils.PropertyUtilsTestCase.testSetIndexedValues()	org.apache.commons.beanutils.PropertyUtils.setIndexedProperty(Object,String,int,Object)
org.apache.commons.beanutils.DynaPropertyUtilsTestCase.testSetSimpleLong()	org.apache.commons.beanutils.PropertyUtils.setSimpleProperty(Object,String,Object)
org.apache.commons.beanutils.BasicDynaBeanTestCase.testSetIndexedArguments()	org.apache.commons.beanutils.DynaBean.set(String,int,Object)
org.apache.commons.beanutils.DynaPropertyUtilsTestCase.testGetIndexedValues()	org.apache.commons.beanutils.PropertyUtils.getIndexedProperty(Object,String)
org.apache.commons.beanutils.BeanUtils.copyProperty(Object,String,Object)	org.apache.commons.beanutils.DynaProperty.getType()
org.apache.commons.beanutils.DynaPropertyUtilsTestCase.testGetNestedInt()	org.apache.commons.beanutils.TestBean.getIntProperty()
org.apache.commons.beanutils.DynaPropertyUtilsTestCase.testGetNestedString()	org.apache.commons.beanutils.TestBean.getStringProperty()
org.apache.commons.beanutils.PropertyUtilsTestCase.testGetMappedArguments()	org.apache.commons.beanutils.PropertyUtils.getMappedProperty(Object,String,String)
org.apache.commons.beanutils.MethodUtils.getAccessibleMethod(Class,String,Class)	org.apache.commons.beanutils.MethodUtils.getAccessibleMethod(Class,String,Class[])
org.apache.commons.beanutils.DynaBeanUtilsTestCase.testPopulateNested()	org.apache.commons.beanutils.TestBean.getStringProperty()
org.apache.commons.beanutils.DynaPropertyUtilsTestCase.testSetMappedValues()	org.apache.commons.beanutils.PropertyUtils.getMappedProperty(Object,String)
org.apache.commons.beanutils.BeanUtils.getSimpleProperty(Object,String)	org.apache.commons.beanutils.ConvertUtils.convert(Object)
org.apache.commons.beanutils.PropertyUtils.getPropertyDescriptors(Object)	org.apache.commons.beanutils.PropertyUtils.getPropertyDescriptors(Class)
org.apache.commons.beanutils.PropertyUtils.getPropertyType(Object,String)	org.apache.commons.beanutils.DynaProperty.getType()
org.apache.commons.beanutils.DynaBeanUtilsTestCase.testPopulateNested()	org.apache.commons.beanutils.TestBean.getBooleanProperty()
org.apache.commons.beanutils.BeanUtilsTestCase.testPopulateArrayProperties()	org.apache.commons.beanutils.BeanUtils.populate(Object,Map)
org.apache.commons.beanutils.DynaResultSetTestCase.testIteratorCount()	org.apache.commons.beanutils.ResultSetDynaClass.iterator()
org.apache.commons.beanutils.PropertyUtils.copyProperties(Object,Object)	org.apache.commons.beanutils.PropertyUtils.getPropertyDescriptors(Object)
org.apache.commons.beanutils.PropertyUtilsTestCase.testSetNestedDouble()	org.apache.commons.beanutils.PropertyUtils.setNestedProperty(Object,String,Object)
org.apache.commons.beanutils.ConvertUtilsTestCase.testNegativeScalar()	org.apache.commons.beanutils.ConvertUtils.convert(String,Class)
org.apache.commons.beanutils.WrapDynaBean.get(String,String)	org.apache.commons.beanutils.PropertyUtils.getMappedProperty(Object,String,String)
org.apache.commons.beanutils.BasicDynaBeanTestCase.testGetSimpleString()	org.apache.commons.beanutils.DynaBean.get(String)
org.apache.commons.beanutils.BasicDynaBeanTestCase.testSetSimpleInt()	org.apache.commons.beanutils.DynaBean.get(String)
org.apache.commons.beanutils.PropertyUtils.setSimpleProperty(Object,String,Object)	org.apache.commons.beanutils.PropertyUtils.getPropertyDescriptor(Object,String)
org.apache.commons.beanutils.DynaPropertyUtilsTestCase.testSetNestedString()	org.apache.commons.beanutils.PropertyUtils.setNestedProperty(Object,String,Object)
org.apache.commons.beanutils.DynaPropertyUtilsTestCase.testSetNestedString()	org.apache.commons.beanutils.TestBean.getStringProperty()
org.apache.commons.beanutils.DynaPropertyUtilsTestCase.testGetMappedValues()	org.apache.commons.beanutils.PropertyUtils.getNestedProperty(Object,String)
org.apache.commons.beanutils.PropertyUtils.getIndexedProperty(Object,String)	org.apache.commons.beanutils.PropertyUtils.getIndexedProperty(Object,String,int)
org.apache.commons.beanutils.BeanUtils.copyProperties(Object,Object)	org.apache.commons.beanutils.DynaProperty.getName()
org.apache.commons.beanutils.BasicDynaBeanTestCase.testGetDescriptorBoolean()	org.apache.commons.beanutils.BasicDynaBeanTestCase.testGetDescriptorBase(String,Class)
org.apache.commons.beanutils.PropertyUtilsTestCase.testSetSimpleString()	org.apache.commons.beanutils.PropertyUtils.setSimpleProperty(Object,String,Object)
org.apache.commons.beanutils.PropertyUtils.getPropertyType(Object,String)	org.apache.commons.beanutils.PropertyUtils.getPropertyDescriptor(Object,String)
org.apache.commons.beanutils.BeanUtils.getSimpleProperty(Object,String)	org.apache.commons.beanutils.PropertyUtils.getSimpleProperty(Object,String)
org.apache.commons.beanutils.PropertyUtilsTestCase.testSetNestedLong()	org.apache.commons.beanutils.TestBean.getNested()
org.apache.commons.beanutils.BeanUtilsTestCase.testCopyPropertiesDynaBean()	org.apache.commons.beanutils.TestBean.getIntProperty()
org.apache.commons.beanutils.PropertyUtilsTestCase.testGetReadMethod(Object,String[],String)	org.apache.commons.beanutils.PropertyUtils.getReadMethod(PropertyDescriptor)
org.apache.commons.beanutils.BeanUtilsTestCase.testPopulateScalar()	org.apache.commons.beanutils.TestBean.getLongProperty()
org.apache.commons.beanutils.MethodUtils.getAccessibleMethodFromInterfaceNest(Class,String,Class[])	org.apache.commons.beanutils.MethodUtils.getAccessibleMethodFromInterfaceNest(Class,String,Class[])
org.apache.commons.beanutils.DynaPropertyUtilsTestCase.testSetMappedValues()	org.apache.commons.beanutils.PropertyUtils.getMappedProperty(Object,String,String)
org.apache.commons.beanutils.PropertyUtilsTestCase.testGetDescriptors()	org.apache.commons.beanutils.PropertyUtils.getPropertyDescriptors(Object)
org.apache.commons.beanutils.PropertyUtils.copyProperties(Object,Object)	org.apache.commons.beanutils.DynaBean.getDynaClass()
org.apache.commons.beanutils.converters.DoubleArrayConverter.convert(Class,Object)	org.apache.commons.beanutils.converters.AbstractArrayConverter.parseElements(String)
org.apache.commons.beanutils.DynaPropertyUtilsTestCase.testGetNestedDouble()	org.apache.commons.beanutils.TestBean.getDoubleProperty()
org.apache.commons.beanutils.DynaPropertyUtilsTestCase.testSetSimpleArguments()	org.apache.commons.beanutils.PropertyUtils.setSimpleProperty(Object,String,Object)
org.apache.commons.beanutils.PropertyUtils.setIndexedProperty(Object,String,int,Object)	org.apache.commons.beanutils.PropertyUtils.getPropertyDescriptor(Object,String)
org.apache.commons.beanutils.DynaPropertyUtilsTestCase.testGetNestedLong()	org.apache.commons.beanutils.TestBean.getLongProperty()
org.apache.commons.beanutils.ConvertingWrapDynaBean.set(String,Object)	org.apache.commons.beanutils.BeanUtils.setProperty(Object,String,Object)
org.apache.commons.beanutils.PropertyUtilsTestCase.testGetSimpleBoolean()	org.apache.commons.beanutils.PropertyUtils.getSimpleProperty(Object,String)
org.apache.commons.beanutils.BasicDynaBeanTestCase.testGetDescriptorBase(String,Class)	org.apache.commons.beanutils.DynaBean.getDynaClass()
org.apache.commons.beanutils.PropertyUtilsTestCase.testGetSimpleReadOnly()	org.apache.commons.beanutils.PropertyUtils.getSimpleProperty(Object,String)
org.apache.commons.beanutils.PropertyUtils.setIndexedProperty(Object,String,int,Object)	org.apache.commons.beanutils.DynaClass.getDynaProperty(String)
org.apache.commons.beanutils.BeanUtilsTestCase.testPopulateArrayElements()	org.apache.commons.beanutils.TestBean.getIntIndexed(int)
org.apache.commons.beanutils.BeanUtilsTestCase.testPopulateMapped()	org.apache.commons.beanutils.TestBean.getMappedProperty(String)
org.apache.commons.beanutils.BeanUtils.copyProperty(Object,String,Object)	org.apache.commons.beanutils.Converter.convert(Class,Object)
org.apache.commons.beanutils.MappedPropertyDescriptor.setMappedReadMethod(Method)	org.apache.commons.beanutils.MappedPropertyDescriptor.findMappedPropertyType()
org.apache.commons.beanutils.WrapDynaClass.introspect()	org.apache.commons.beanutils.PropertyUtils.getMappedPropertyDescriptors(Class)
org.apache.commons.beanutils.PropertyUtils.getWriteMethod(PropertyDescriptor)	org.apache.commons.beanutils.MethodUtils.getAccessibleMethod(Method)
org.apache.commons.beanutils.BeanUtilsTestCase.testCopyPropertiesStandard()	org.apache.commons.beanutils.TestBean.getIntProperty()
org.apache.commons.beanutils.PropertyUtils.getPropertyDescriptor(Object,String)	org.apache.commons.beanutils.PropertyUtils.getMappedProperty(Object,String)
org.apache.commons.beanutils.converters.FloatArrayConverter.convert(Class,Object)	org.apache.commons.beanutils.converters.AbstractArrayConverter.parseElements(String)
org.apache.commons.beanutils.BeanUtilsTestCase.testGetNestedProperty()	org.apache.commons.beanutils.TestBean.getNested()
org.apache.commons.beanutils.PropertyUtils.getPropertyType(Object,String)	org.apache.commons.beanutils.DynaClass.getDynaProperty(String)
org.apache.commons.beanutils.PropertyUtilsTestCase.testGetNestedInt()	org.apache.commons.beanutils.TestBean.getNested()
org.apache.commons.beanutils.DynaPropertyUtilsTestCase.testGetSimpleFloat()	org.apache.commons.beanutils.PropertyUtils.getSimpleProperty(Object,String)
org.apache.commons.beanutils.PropertyUtils.copyProperties(Object,Object)	org.apache.commons.beanutils.PropertyUtils.setSimpleProperty(Object,String,Object)
org.apache.commons.beanutils.BasicDynaBeanTestCase.testGetSimpleBoolean()	org.apache.commons.beanutils.DynaBean.get(String)
org.apache.commons.beanutils.PropertyUtilsTestCase.testSetSimpleBoolean()	org.apache.commons.beanutils.PropertyUtils.setSimpleProperty(Object,String,Object)
org.apache.commons.beanutils.BeanUtils.setProperty(Object,String,Object)	org.apache.commons.beanutils.DynaProperty.getType()
org.apache.commons.beanutils.BasicDynaBeanTestCase.testSetIndexedValues()	org.apache.commons.beanutils.DynaBean.set(String,int,Object)
org.apache.commons.beanutils.BasicDynaBean.set(String,Object)	org.apache.commons.beanutils.DynaProperty.getType()
org.apache.commons.beanutils.PropertyUtils.setMappedProperty(Object,String,String,Object)	org.apache.commons.beanutils.DynaBean.set(String,String,Object)
org.apache.commons.beanutils.BasicDynaBean.getDynaProperty(String)	org.apache.commons.beanutils.DynaClass.getDynaProperty(String)
org.apache.commons.beanutils.DynaBeanUtilsTestCase.testGetIndexedProperty2()	org.apache.commons.beanutils.BeanUtils.getIndexedProperty(Object,String,int)
org.apache.commons.beanutils.DynaPropertyUtilsTestCase.testGetNestedFloat()	org.apache.commons.beanutils.TestBean.getFloatProperty()
org.apache.commons.beanutils.DynaResultSetTestCase.testIteratorResults()	org.apache.commons.beanutils.ResultSetDynaClass.iterator()
org.apache.commons.beanutils.PropertyUtils.copyProperties(Object,Object)	org.apache.commons.beanutils.PropertyUtils.getPropertyDescriptor(Object,String)
org.apache.commons.beanutils.PropertyUtils.setMappedProperty(Object,String,Object)	org.apache.commons.beanutils.PropertyUtils.setMappedProperty(Object,String,String,Object)
org.apache.commons.beanutils.PropertyUtils.setNestedProperty(Object,String,Object)	org.apache.commons.beanutils.PropertyUtils.getSimpleProperty(Object,String)
org.apache.commons.beanutils.PropertyUtilsTestCase.testSetMappedValues()	org.apache.commons.beanutils.PropertyUtils.getNestedProperty(Object,String)
org.apache.commons.beanutils.PropertyUtilsTestCase.testSetNestedShort()	org.apache.commons.beanutils.TestBean.getShortProperty()
org.apache.commons.beanutils.PropertyUtilsTestCase.testSetSimpleDouble()	org.apache.commons.beanutils.TestBean.getDoubleProperty()
org.apache.commons.beanutils.PropertyUtilsTestCase.testGetSimpleReadOnly()	org.apache.commons.beanutils.TestBean.getReadOnlyProperty()
org.apache.commons.beanutils.PropertyUtilsTestCase.testGetIndexedValues()	org.apache.commons.beanutils.PropertyUtils.getIndexedProperty(Object,String)
org.apache.commons.beanutils.PropertyUtilsTestCase.testGetNestedInt()	org.apache.commons.beanutils.TestBean.getIntProperty()
org.apache.commons.beanutils.converters.CharacterArrayConverter.convert(Class,Object)	org.apache.commons.beanutils.converters.AbstractArrayConverter.parseElements(String)
org.apache.commons.beanutils.PropertyUtilsTestCase.testGetDescriptorInt()	org.apache.commons.beanutils.PropertyUtilsTestCase.testGetDescriptorBase(String,String,String)
org.apache.commons.beanutils.DynaPropertyUtilsTestCase.testSetMappedValues()	org.apache.commons.beanutils.PropertyUtils.setMappedProperty(Object,String,Object)
org.apache.commons.beanutils.PropertyUtilsTestCase.testSetNestedDouble()	org.apache.commons.beanutils.TestBean.getNested()
org.apache.commons.beanutils.BasicDynaBeanTestCase.testGetDescriptorSecond()	org.apache.commons.beanutils.BasicDynaBeanTestCase.testGetDescriptorBase(String,Class)
org.apache.commons.beanutils.BeanUtilsTestCase.testCopyPropertiesStandard()	org.apache.commons.beanutils.TestBean.getBooleanProperty()
org.apache.commons.beanutils.DynaBeanUtilsTestCase.testPopulateNested()	org.apache.commons.beanutils.TestBean.getLongProperty()
org.apache.commons.beanutils.ResultSetIterator.advance()	org.apache.commons.beanutils.ResultSetDynaClass.getResultSet()
org.apache.commons.beanutils.PropertyUtils.getPropertyDescriptor(Object,String)	org.apache.commons.beanutils.PropertyUtils.getIndexedProperty(Object,String)
org.apache.commons.beanutils.DynaBeanUtilsTestCase.testCopyPropertiesStandard()	org.apache.commons.beanutils.TestBean.setDoubleProperty(double)
org.apache.commons.beanutils.PropertyUtilsTestCase.testGetDescriptorShort()	org.apache.commons.beanutils.PropertyUtilsTestCase.testGetDescriptorBase(String,String,String)
org.apache.commons.beanutils.BeanUtilsTestCase.testDescribe()	org.apache.commons.beanutils.BeanUtils.describe(Object)
org.apache.commons.beanutils.DynaPropertyUtilsTestCase.testSetSimpleFloat()	org.apache.commons.beanutils.DynaBean.get(String)
org.apache.commons.beanutils.PropertyUtilsTestCase.testGetNestedShort()	org.apache.commons.beanutils.TestBean.getShortProperty()
org.apache.commons.beanutils.DynaPropertyUtilsTestCase.testGetNestedShort()	org.apache.commons.beanutils.DynaBean.get(String)
org.apache.commons.beanutils.BasicDynaBean.get(String)	org.apache.commons.beanutils.BasicDynaBean.getDynaProperty(String)
org.apache.commons.beanutils.BeanUtils.copyProperties(Object,Object)	org.apache.commons.beanutils.DynaClass.getDynaProperties()
org.apache.commons.beanutils.DynaBeanUtilsTestCase.testPopulateArrayProperties()	org.apache.commons.beanutils.BeanUtils.populate(Object,Map)
org.apache.commons.beanutils.WrapDynaBean.getDynaProperty(String)	org.apache.commons.beanutils.WrapDynaBean.getDynaClass()
org.apache.commons.beanutils.PropertyUtilsTestCase.testSetNestedLong()	org.apache.commons.beanutils.PropertyUtils.setNestedProperty(Object,String,Object)
org.apache.commons.beanutils.BeanUtils.getArrayProperty(Object,String)	org.apache.commons.beanutils.PropertyUtils.getProperty(Object,String)
org.apache.commons.beanutils.BeanUtilsTestCase.testPopulateScalar()	org.apache.commons.beanutils.TestBean.isBooleanSecond()
org.apache.commons.beanutils.PropertyUtils.getNestedProperty(Object,String)	org.apache.commons.beanutils.PropertyUtils.getSimpleProperty(Object,String)
org.apache.commons.beanutils.PropertyUtils.getMappedProperty(Object,String)	org.apache.commons.beanutils.PropertyUtils.getMappedProperty(Object,String,String)
org.apache.commons.beanutils.DynaPropertyUtilsTestCase.testSetMappedArguments()	org.apache.commons.beanutils.PropertyUtils.setMappedProperty(Object,String,Object)
org.apache.commons.beanutils.BeanUtilsTestCase.testPopulateNested()	org.apache.commons.beanutils.TestBean.isBooleanSecond()
org.apache.commons.beanutils.DynaPropertyUtilsTestCase.testGetNestedShort()	org.apache.commons.beanutils.PropertyUtils.getNestedProperty(Object,String)
org.apache.commons.beanutils.BeanUtilsTestCase.testCopyPropertiesDynaBean()	org.apache.commons.beanutils.DynaBean.set(String,Object)
org.apache.commons.beanutils.PropertyUtils.getMappedProperty(Object,String,String)	org.apache.commons.beanutils.DynaBean.get(String,String)
org.apache.commons.beanutils.BasicDynaBeanTestCase.testGetDescriptorLong()	org.apache.commons.beanutils.BasicDynaBeanTestCase.testGetDescriptorBase(String,Class)
org.apache.commons.beanutils.BeanUtilsTestCase.testGetGeneralProperty()	org.apache.commons.beanutils.BeanUtils.getProperty(Object,String)
org.apache.commons.beanutils.PropertyUtilsTestCase.testGetWriteMethodBasic()	org.apache.commons.beanutils.PropertyUtilsTestCase.testGetWriteMethod(Object,String[],String)
org.apache.commons.beanutils.DynaPropertyUtilsTestCase.setUp()	org.apache.commons.beanutils.DynaBean.set(String,Object)
org.apache.commons.beanutils.BasicDynaBeanTestCase.testGetDescriptorString()	org.apache.commons.beanutils.BasicDynaBeanTestCase.testGetDescriptorBase(String,Class)
org.apache.commons.beanutils.PropertyUtils.getIndexedProperty(Object,String,int)	org.apache.commons.beanutils.PropertyUtils.getReadMethod(PropertyDescriptor)
org.apache.commons.beanutils.BasicDynaBeanTestCase.testGetDescriptorDouble()	org.apache.commons.beanutils.BasicDynaBeanTestCase.testGetDescriptorBase(String,Class)
org.apache.commons.beanutils.DynaPropertyUtilsTestCase.testGetNestedReadOnly()	org.apache.commons.beanutils.TestBean.getReadOnlyProperty()
org.apache.commons.beanutils.BeanUtilsTestCase.testCopyPropertiesDynaBean()	org.apache.commons.beanutils.DynaBeanUtilsTestCase.createDynaClass()
org.apache.commons.beanutils.ResultSetIterator.set(String,Object)	org.apache.commons.beanutils.ResultSetDynaClass.getResultSet()
org.apache.commons.beanutils.BeanUtilsTestCase.testPopulateScalar()	org.apache.commons.beanutils.TestBean.getReadOnlyProperty()
org.apache.commons.beanutils.BeanUtils.describe(Object)	org.apache.commons.beanutils.DynaBean.getDynaClass()
org.apache.commons.beanutils.DynaBeanUtilsTestCase.testGetArrayProperty()	org.apache.commons.beanutils.DynaBean.get(String)
org.apache.commons.beanutils.PropertyUtilsTestCase.testSetNestedDouble()	org.apache.commons.beanutils.TestBean.getDoubleProperty()
org.apache.commons.beanutils.DynaPropertyUtilsTestCase.testSetMappedValues()	org.apache.commons.beanutils.PropertyUtils.getNestedProperty(Object,String)
org.apache.commons.beanutils.DynaPropertyUtilsTestCase.testDescribe()	org.apache.commons.beanutils.PropertyUtils.describe(Object)
org.apache.commons.beanutils.DynaPropertyUtilsTestCase.testGetMappedArguments()	org.apache.commons.beanutils.PropertyUtils.getMappedProperty(Object,String,String)
org.apache.commons.beanutils.DynaBeanUtilsTestCase.testGetNestedProperty()	org.apache.commons.beanutils.BeanUtils.getNestedProperty(Object,String)
org.apache.commons.beanutils.BeanUtils.copyProperty(Object,String,Object)	org.apache.commons.beanutils.DynaClass.getDynaProperty(String)
org.apache.commons.beanutils.BeanUtils.getIndexedProperty(Object,String)	org.apache.commons.beanutils.ConvertUtils.convert(Object)
org.apache.commons.beanutils.DynaBeanUtilsTestCase.testCopyPropertiesDynaBean()	org.apache.commons.beanutils.DynaClass.newInstance()
org.apache.commons.beanutils.BasicDynaBeanTestCase.testSetMappedValues()	org.apache.commons.beanutils.DynaBean.get(String,String)
org.apache.commons.beanutils.DynaBeanUtilsTestCase.testGetIndexedProperty1()	org.apache.commons.beanutils.BeanUtils.getIndexedProperty(Object,String)
org.apache.commons.beanutils.PropertyUtilsTestCase.testGetIndexedArguments()	org.apache.commons.beanutils.PropertyUtils.getIndexedProperty(Object,String)
org.apache.commons.beanutils.PropertyUtilsTestCase.testGetSimpleInt()	org.apache.commons.beanutils.TestBean.getIntProperty()
org.apache.commons.beanutils.MethodUtilsTestCase.testGetAccessibleMethod()	org.apache.commons.beanutils.priv.PrivateBeanFactory.create()
org.apache.commons.beanutils.PropertyUtilsTestCase.testGetNestedLong()	org.apache.commons.beanutils.TestBean.getLongProperty()
org.apache.commons.beanutils.PropertyUtilsTestCase.testSetSimpleShort()	org.apache.commons.beanutils.PropertyUtils.setSimpleProperty(Object,String,Object)
org.apache.commons.beanutils.BasicDynaBeanTestCase.setUp()	org.apache.commons.beanutils.BasicDynaBeanTestCase.createDynaClass()
org.apache.commons.beanutils.MethodUtils.invokeMethod(Object,String,Object[],Class[])	org.apache.commons.beanutils.MethodUtils.getMatchingAccessibleMethod(Class,String,Class[])
org.apache.commons.beanutils.BasicDynaBeanTestCase.testGetDescriptorInt()	org.apache.commons.beanutils.BasicDynaBeanTestCase.testGetDescriptorBase(String,Class)
org.apache.commons.beanutils.PropertyUtilsTestCase.testGetNestedShort()	org.apache.commons.beanutils.PropertyUtils.getNestedProperty(Object,String)
org.apache.commons.beanutils.DynaBeanUtilsTestCase.testGetGeneralProperty()	org.apache.commons.beanutils.BeanUtils.getProperty(Object,String)
org.apache.commons.beanutils.MethodUtilsTestCase.testInvokeMethod()	org.apache.commons.beanutils.MethodUtils.invokeMethod(Object,String,Object)
org.apache.commons.beanutils.ConvertUtils.convert(String[],Class)	org.apache.commons.beanutils.Converter.convert(Class,Object)
org.apache.commons.beanutils.ConvertUtilsTestCase.testNegativeStringArray()	org.apache.commons.beanutils.ConvertUtilsTestCase.checkStringArray(Object,String[])
org.apache.commons.beanutils.WrapDynaBean.set(String,int,Object)	org.apache.commons.beanutils.WrapDynaBean.getDynaProperty(String)
org.apache.commons.beanutils.BeanUtilsTestCase.testCopyPropertiesDynaBean()	org.apache.commons.beanutils.TestBean.getBooleanProperty()
org.apache.commons.beanutils.BeanUtilsTestCase.testPopulateNested()	org.apache.commons.beanutils.TestBean.getShortProperty()
org.apache.commons.beanutils.PropertyUtilsTestCase.testGetMappedValues()	org.apache.commons.beanutils.PropertyUtils.getMappedProperty(Object,String,String)
org.apache.commons.beanutils.PropertyUtilsTestCase.testGetNestedLong()	org.apache.commons.beanutils.PropertyUtils.getNestedProperty(Object,String)
org.apache.commons.beanutils.PropertyUtilsTestCase.testSetSimpleNested()	org.apache.commons.beanutils.PropertyUtils.setSimpleProperty(Object,String,Object)
org.apache.commons.beanutils.DynaBeanUtilsTestCase.testPopulateArrayProperties()	org.apache.commons.beanutils.DynaBean.get(String)
org.apache.commons.beanutils.BeanUtilsTestCase.testCopyPropertiesStandard()	org.apache.commons.beanutils.TestBean.setLongProperty(long)
org.apache.commons.beanutils.DynaPropertyUtilsTestCase.testGetNestedLong()	org.apache.commons.beanutils.PropertyUtils.getNestedProperty(Object,String)
org.apache.commons.beanutils.DynaPropertyUtilsTestCase.testGetNestedInt()	org.apache.commons.beanutils.DynaBean.get(String)
org.apache.commons.beanutils.DynaPropertyUtilsTestCase.testSetNestedShort()	org.apache.commons.beanutils.TestBean.getShortProperty()
org.apache.commons.beanutils.PropertyUtils.setSimpleProperty(Object,String,Object)	org.apache.commons.beanutils.DynaClass.getDynaProperty(String)
org.apache.commons.beanutils.DynaBeanUtilsTestCase.testPopulateNested()	org.apache.commons.beanutils.TestBean.isBooleanSecond()
org.apache.commons.beanutils.BasicDynaBean.get(String,int)	org.apache.commons.beanutils.BasicDynaBean.getDynaProperty(String)
org.apache.commons.beanutils.MappedPropertyDescriptor.internalFindMethod(Class,String,int,Class[])	org.apache.commons.beanutils.MappedPropertyDescriptor.internalFindMethod(Class,String,int)
org.apache.commons.beanutils.PropertyUtilsTestCase.testSetNestedString()	org.apache.commons.beanutils.TestBean.getNested()
org.apache.commons.beanutils.MethodUtils.getMatchingAccessibleMethod(Class,String,Class[])	org.apache.commons.beanutils.MethodUtils.getAccessibleMethod(Method)
org.apache.commons.beanutils.PropertyUtils.describe(Object)	org.apache.commons.beanutils.DynaProperty.getName()
org.apache.commons.beanutils.PropertyUtilsTestCase.testGetDescriptorWriteOnly()	org.apache.commons.beanutils.PropertyUtilsTestCase.testGetDescriptorBase(String,String,String)
org.apache.commons.beanutils.BeanUtilsTestCase.testCopyPropertiesStandard()	org.apache.commons.beanutils.TestBean.setStringArray(String[])
org.apache.commons.beanutils.BasicDynaBean.set(String,Object)	org.apache.commons.beanutils.BasicDynaBean.isAssignable(Class,Class)
org.apache.commons.beanutils.DynaBeanUtilsTestCase.testCopyPropertiesStandard()	org.apache.commons.beanutils.TestBean.setShortProperty(short)
org.apache.commons.beanutils.BeanUtilsTestCase.testGetIndexedProperty1()	org.apache.commons.beanutils.BeanUtils.getIndexedProperty(Object,String)
org.apache.commons.beanutils.MethodUtilsTestCase.testInvokeExactMethod()	org.apache.commons.beanutils.priv.PrivateBeanFactory.createSubclass()
org.apache.commons.beanutils.DynaPropertyUtilsTestCase.testSetSimpleIndexed()	org.apache.commons.beanutils.PropertyUtils.setSimpleProperty(Object,String,Object)
org.apache.commons.beanutils.DynaPropertyUtilsTestCase.testSetNestedFloat()	org.apache.commons.beanutils.PropertyUtils.setNestedProperty(Object,String,Object)
org.apache.commons.beanutils.MethodUtilsTestCase.testInvokeMethod()	org.apache.commons.beanutils.AbstractParent.testAddChild2(String,Child)
org.apache.commons.beanutils.DynaPropertyUtilsTestCase.testSetNestedBoolean()	org.apache.commons.beanutils.PropertyUtils.setNestedProperty(Object,String,Object)
org.apache.commons.beanutils.WrapDynaBean.set(String,Object)	org.apache.commons.beanutils.WrapDynaBean.getDynaProperty(String)
org.apache.commons.beanutils.BeanUtilsTestCase.testGetNestedProperty()	org.apache.commons.beanutils.BeanUtils.getNestedProperty(Object,String)
org.apache.commons.beanutils.DynaPropertyUtilsTestCase.testSetSimpleBoolean()	org.apache.commons.beanutils.PropertyUtils.setSimpleProperty(Object,String,Object)
org.apache.commons.beanutils.PropertyUtilsTestCase.testGetNestedDouble()	org.apache.commons.beanutils.TestBean.getDoubleProperty()
org.apache.commons.beanutils.BasicDynaBeanTestCase.testGetMappedValues()	org.apache.commons.beanutils.DynaBean.get(String,String)
org.apache.commons.beanutils.DynaBeanUtilsTestCase.testPopulateNested()	org.apache.commons.beanutils.TestBean.getShortProperty()
