Caller	Callee
org.apache.commons.codec.language.DoubleMetaphone.handleC(String,DoubleMetaphoneResult,int)	org.apache.commons.codec.language.DoubleMetaphone.DoubleMetaphoneResult.append(char,char)
org.apache.commons.codec.binary.BinaryCodec.toAsciiString(byte[])	org.apache.commons.codec.binary.BinaryCodec.toAsciiChars(byte[])
org.apache.commons.codec.binary.Base64TestData.randomData(int,boolean)	org.apache.commons.codec.binary.Base64.encodeBase64(byte[])
org.apache.commons.codec.digest.DigestUtilsTest.testSha512()	org.apache.commons.codec.digest.DigestUtils.sha512Hex(String)
org.apache.commons.codec.net.URLCodecTest.testEncodeObjects()	org.apache.commons.codec.net.URLCodec.encode(Object)
org.apache.commons.codec.binary.BinaryCodecTest.testToByteArrayFromString()	org.apache.commons.codec.binary.BinaryCodec.toByteArray(String)
org.apache.commons.codec.language.RefinedSoundex.encode(Object)	org.apache.commons.codec.language.RefinedSoundex.soundex(String)
org.apache.commons.codec.language.DoubleMetaphone.handleW(String,DoubleMetaphoneResult,int)	org.apache.commons.codec.language.DoubleMetaphone.DoubleMetaphoneResult.append(char)
org.apache.commons.codec.language.DoubleMetaphone.conditionM0(String,int)	org.apache.commons.codec.language.DoubleMetaphone.charAt(String,int)
org.apache.commons.codec.net.BCodecTest.testBasicEncodeDecode()	org.apache.commons.codec.net.BCodec.decode(String)
org.apache.commons.codec.net.URLCodecTest.testEncodeUrlWithNullBitSet()	org.apache.commons.codec.net.URLCodec.encodeUrl(BitSet,byte[])
org.apache.commons.codec.net.QuotedPrintableCodec.encode(String)	org.apache.commons.codec.net.QuotedPrintableCodec.getDefaultCharset()
org.apache.commons.codec.language.DoubleMetaphone.handleW(String,DoubleMetaphoneResult,int)	org.apache.commons.codec.language.DoubleMetaphone.charAt(String,int)
org.apache.commons.codec.language.DoubleMetaphone.DoubleMetaphoneResult.append(String)	org.apache.commons.codec.language.DoubleMetaphone.DoubleMetaphoneResult.appendPrimary(String)
org.apache.commons.codec.binary.Base64.encodeInteger(BigInteger)	org.apache.commons.codec.binary.Base64.encodeBase64(byte[],boolean)
org.apache.commons.codec.binary.Base64Test.testUUID()	org.apache.commons.codec.binary.StringBytesUtils.getBytesUtf8(String)
org.apache.commons.codec.language.DoubleMetaphone.handleC(String,DoubleMetaphoneResult,int)	org.apache.commons.codec.language.DoubleMetaphone.handleCC(String,DoubleMetaphoneResult,int)
org.apache.commons.codec.net.URLCodecTest.testInvalidEncoding()	org.apache.commons.codec.net.URLCodec.encode(String)
org.apache.commons.codec.StringEncoderAbstractTest.testEncodeEmpty()	org.apache.commons.codec.StringEncoderAbstractTest.makeEncoder()
org.apache.commons.codec.binary.Base64.encodeBase64URLSafe(byte[])	org.apache.commons.codec.binary.Base64.encodeBase64(byte[],boolean,boolean)
org.apache.commons.codec.digest.DigestUtils.sha384Hex(byte[])	org.apache.commons.codec.digest.DigestUtils.sha384(byte[])
org.apache.commons.codec.language.DoubleMetaphone.handleS(String,DoubleMetaphoneResult,int,boolean)	org.apache.commons.codec.language.DoubleMetaphone.DoubleMetaphoneResult.appendAlternate(char)
org.apache.commons.codec.language.DoubleMetaphone.conditionC0(String,int)	org.apache.commons.codec.language.DoubleMetaphone.charAt(String,int)
org.apache.commons.codec.net.URLCodecTest.testEncodeObjects()	org.apache.commons.codec.net.URLCodecTest.validateState(URLCodec)
org.apache.commons.codec.binary.BinaryCodecTest.assertDecodeObject(byte[],String)	org.apache.commons.codec.binary.BinaryCodec.decode(byte[])
org.apache.commons.codec.language.DoubleMetaphone.handleX(String,DoubleMetaphoneResult,int)	org.apache.commons.codec.language.DoubleMetaphone.DoubleMetaphoneResult.append(char)
org.apache.commons.codec.net.QuotedPrintableCodec.encode(String)	org.apache.commons.codec.net.QuotedPrintableCodec.encode(String,String)
org.apache.commons.codec.binary.Base64Test.testChunkedEncodeMultipleOf76()	org.apache.commons.codec.binary.Base64.encodeBase64(byte[],boolean)
org.apache.commons.codec.digest.DigestUtils.sha(InputStream)	org.apache.commons.codec.digest.DigestUtils.digest(MessageDigest,InputStream)
org.apache.commons.codec.binary.Base64Test.testCodeInteger4()	org.apache.commons.codec.binary.Base64.decodeInteger(byte[])
org.apache.commons.codec.net.QCodec.encode(Object)	org.apache.commons.codec.net.QCodec.encode(String)
org.apache.commons.codec.net.QuotedPrintableCodecTest.testUTF8RoundTrip()	org.apache.commons.codec.net.QuotedPrintableCodecTest.constructString(int[])
org.apache.commons.codec.net.URLCodecTest.testEncodeDecodeNull()	org.apache.commons.codec.net.URLCodec.decode(String)
org.apache.commons.codec.net.URLCodecTest.testDecodeInvalid()	org.apache.commons.codec.net.URLCodec.decode(String)
org.apache.commons.codec.binary.Base64Test.testObjectEncodeWithInvalidParameter()	org.apache.commons.codec.binary.Base64.encode(Object)
org.apache.commons.codec.net.BCodecTest.testEncodeDecodeNull()	org.apache.commons.codec.net.BCodec.encode(String)
org.apache.commons.codec.language.DoubleMetaphone.conditionC0(String,int)	org.apache.commons.codec.language.DoubleMetaphone.contains(String,int,int,String,String)
org.apache.commons.codec.net.QuotedPrintableCodecTest.testUTF8RoundTrip()	org.apache.commons.codec.net.QuotedPrintableCodec.decode(String,String)
org.apache.commons.codec.net.URLCodec.encode(String,String)	org.apache.commons.codec.binary.StringBytesUtils.newStringUsAscii(byte[])
org.apache.commons.codec.net.RFC1522Codec.decodeText(String)	org.apache.commons.codec.net.RFC1522Codec.getEncoding()
org.apache.commons.codec.binary.HexTest.testEncodeZeroes()	org.apache.commons.codec.binary.Hex.encodeHex(byte[])
org.apache.commons.codec.binary.Base64Test.testSingletonsChunked()	org.apache.commons.codec.binary.Base64.encodeBase64Chunked(byte[])
org.apache.commons.codec.language.DoubleMetaphone.handleW(String,DoubleMetaphoneResult,int)	org.apache.commons.codec.language.DoubleMetaphone.isVowel(char)
org.apache.commons.codec.language.DoubleMetaphone.DoubleMetaphoneResult.append(char,char)	org.apache.commons.codec.language.DoubleMetaphone.DoubleMetaphoneResult.appendPrimary(char)
org.apache.commons.codec.net.BCodecTest.testEncodeDecodeNull()	org.apache.commons.codec.net.BCodec.decode(String)
org.apache.commons.codec.net.URLCodec.encode(byte[])	org.apache.commons.codec.net.URLCodec.encodeUrl(BitSet,byte[])
org.apache.commons.codec.net.QCodecTest.testNullInput()	org.apache.commons.codec.net.QCodec.doDecoding(byte[])
org.apache.commons.codec.binary.Base64Test.testDecodePadOnlyChunked()	org.apache.commons.codec.binary.Base64.decodeBase64(byte[])
org.apache.commons.codec.net.URLCodecTest.testInvalidEncoding()	org.apache.commons.codec.net.URLCodec.decode(String)
org.apache.commons.codec.binary.Base64Test.testEncodeDecodeRandom()	org.apache.commons.codec.binary.Base64.encodeBase64(byte[])
org.apache.commons.codec.net.URLCodecTest.testDecodeInvalidContent()	org.apache.commons.codec.net.URLCodecTest.constructString(int[])
org.apache.commons.codec.language.Metaphone.metaphone(String)	org.apache.commons.codec.language.Metaphone.regionMatch(StringBuffer,int,String)
org.apache.commons.codec.binary.Base64Test.testCodeInteger3()	org.apache.commons.codec.binary.Base64.decodeInteger(byte[])
org.apache.commons.codec.binary.Base64Test.testNonBase64Test()	org.apache.commons.codec.binary.Base64.decode(byte[])
org.apache.commons.codec.net.RFC1522Codec.encodeText(String,String)	org.apache.commons.codec.net.RFC1522Codec.getEncoding()
org.apache.commons.codec.language.DoubleMetaphone.handleZ(String,DoubleMetaphoneResult,int,boolean)	org.apache.commons.codec.language.DoubleMetaphone.DoubleMetaphoneResult.append(char)
org.apache.commons.codec.language.DoubleMetaphone.DoubleMetaphoneResult.append(char,char)	org.apache.commons.codec.language.DoubleMetaphone.DoubleMetaphoneResult.appendAlternate(char)
org.apache.commons.codec.binary.StringBytesUtilsTest.testGetBytesUtf16()	org.apache.commons.codec.binary.StringBytesUtils.getBytesUtf16(String)
org.apache.commons.codec.language.Soundex.encode(Object)	org.apache.commons.codec.language.Soundex.soundex(String)
org.apache.commons.codec.binary.StringBytesUtils.newStringUtf16Le(byte[])	org.apache.commons.codec.binary.StringBytesUtils.newString(byte[],String)
org.apache.commons.codec.binary.Base64Test.testDiscardWhitespace()	org.apache.commons.codec.binary.Base64.encodeBase64(byte[])
org.apache.commons.codec.binary.Base64Test.testDecodePadOnly()	org.apache.commons.codec.binary.Base64.decodeBase64(byte[])
org.apache.commons.codec.digest.DigestUtils.sha384Hex(String)	org.apache.commons.codec.binary.Hex.encodeHex(byte[])
org.apache.commons.codec.binary.Hex.decode(Object)	org.apache.commons.codec.binary.Hex.decodeHex(char[])
org.apache.commons.codec.language.DoubleMetaphone.handleX(String,DoubleMetaphoneResult,int)	org.apache.commons.codec.language.DoubleMetaphone.contains(String,int,int,String,String)
org.apache.commons.codec.language.Metaphone.metaphone(String)	org.apache.commons.codec.language.Metaphone.getMaxCodeLen()
org.apache.commons.codec.net.QuotedPrintableCodecTest.testUnsafeEncodeDecode()	org.apache.commons.codec.net.QuotedPrintableCodec.decode(String)
org.apache.commons.codec.net.QuotedPrintableCodecTest.testDecodeInvalid()	org.apache.commons.codec.net.QuotedPrintableCodec.decode(String)
org.apache.commons.codec.binary.Base64InputStream.read()	org.apache.commons.codec.binary.Base64InputStream.read(byte[],int,int)
org.apache.commons.codec.binary.Base64Test.testEncodeDecodeRandom()	org.apache.commons.codec.binary.Base64.isArrayByteBase64(byte[])
org.apache.commons.codec.net.BCodecTest.testBasicEncodeDecode()	org.apache.commons.codec.net.BCodec.encode(String)
org.apache.commons.codec.binary.BinaryCodecTest.testDecodeObject()	org.apache.commons.codec.binary.BinaryCodecTest.assertDecodeObject(byte[],String)
org.apache.commons.codec.net.QuotedPrintableCodecTest.testDecodeWithNullArray()	org.apache.commons.codec.net.QuotedPrintableCodec.decodeQuotedPrintable(byte[])
org.apache.commons.codec.binary.HexTest.testHelloWorldLowerCaseHex()	org.apache.commons.codec.binary.Hex.encodeHex(byte[],boolean)
org.apache.commons.codec.net.URLCodecTest.validateState(URLCodec)	org.apache.commons.codec.net.URLCodec.getDefaultCharset()
org.apache.commons.codec.language.DoubleMetaphone.conditionCH1(String,int)	org.apache.commons.codec.language.DoubleMetaphone.contains(String,int,int,String)
org.apache.commons.codec.binary.HexTest.testDecodeBadCharacterPos0()	org.apache.commons.codec.binary.Hex.decode(Object)
org.apache.commons.codec.binary.Base64.decodeBase64(byte[])	org.apache.commons.codec.binary.Base64.decode(byte[],int,int)
org.apache.commons.codec.language.Caverphone.isCaverphoneEqual(String,String)	org.apache.commons.codec.language.Caverphone.caverphone(String)
org.apache.commons.codec.binary.Base64Test.testEncodeDecodeSmall()	org.apache.commons.codec.binary.Base64Test.getRandom()
org.apache.commons.codec.net.URLCodecTest.testDecodeObjects()	org.apache.commons.codec.net.URLCodecTest.validateState(URLCodec)
org.apache.commons.codec.language.Soundex.difference(String,String)	org.apache.commons.codec.language.SoundexUtils.difference(StringEncoder,String,String)
org.apache.commons.codec.net.URLCodecTest.testDecodeWithNullArray()	org.apache.commons.codec.net.URLCodec.decodeUrl(byte[])
org.apache.commons.codec.binary.Base64InputStream.read(byte[],int,int)	org.apache.commons.codec.binary.Base64.decode(byte[],int,int)
org.apache.commons.codec.binary.Base64.decodeInteger(byte[])	org.apache.commons.codec.binary.Base64.decodeBase64(byte[])
org.apache.commons.codec.language.DoubleMetaphone.handleSC(String,DoubleMetaphoneResult,int)	org.apache.commons.codec.language.DoubleMetaphone.contains(String,int,int,String,String,String,String,String,String)
org.apache.commons.codec.language.DoubleMetaphone.handleS(String,DoubleMetaphoneResult,int,boolean)	org.apache.commons.codec.language.DoubleMetaphone.handleSC(String,DoubleMetaphoneResult,int)
org.apache.commons.codec.digest.DigestUtils.sha384Hex(InputStream)	org.apache.commons.codec.binary.Hex.encodeHex(byte[])
org.apache.commons.codec.net.URLCodecTest.testUTF8RoundTrip()	org.apache.commons.codec.net.URLCodecTest.constructString(int[])
org.apache.commons.codec.language.DoubleMetaphone.encode(Object)	org.apache.commons.codec.language.DoubleMetaphone.doubleMetaphone(String)
org.apache.commons.codec.binary.StringBytesUtilsTest.testNewStringUtf16()	org.apache.commons.codec.binary.StringBytesUtils.newStringUtf16(byte[])
org.apache.commons.codec.language.SoundexTest.testMaxLength()	org.apache.commons.codec.language.Soundex.getMaxLength()
org.apache.commons.codec.language.DoubleMetaphone.doubleMetaphone(String,boolean)	org.apache.commons.codec.language.DoubleMetaphone.getMaxCodeLen()
org.apache.commons.codec.binary.HexTest.testEncodeEmpty()	org.apache.commons.codec.binary.Hex.encodeHex(byte[])
org.apache.commons.codec.net.URLCodecTest.testEncodeNull()	org.apache.commons.codec.net.URLCodecTest.validateState(URLCodec)
org.apache.commons.codec.digest.DigestUtils.md5(InputStream)	org.apache.commons.codec.digest.DigestUtils.getMd5Digest()
org.apache.commons.codec.language.DoubleMetaphone.doubleMetaphone(String,boolean)	org.apache.commons.codec.language.DoubleMetaphone.handleH(String,DoubleMetaphoneResult,int)
org.apache.commons.codec.language.DoubleMetaphone.handleCH(String,DoubleMetaphoneResult,int)	org.apache.commons.codec.language.DoubleMetaphone.conditionCH0(String,int)
org.apache.commons.codec.binary.Base64OutputStreamTest.testBase64OutputStreamByteByByte()	org.apache.commons.codec.binary.StringBytesUtils.getBytesUtf8(String)
org.apache.commons.codec.binary.Base64Test.testCodec68()	org.apache.commons.codec.binary.Base64.decodeBase64(byte[])
org.apache.commons.codec.digest.DigestUtils.md5Hex(InputStream)	org.apache.commons.codec.binary.Hex.encodeHex(byte[])
org.apache.commons.codec.language.DoubleMetaphone.doubleMetaphone(String,boolean)	org.apache.commons.codec.language.DoubleMetaphone.handleG(String,DoubleMetaphoneResult,int,boolean)
org.apache.commons.codec.net.QuotedPrintableCodec.decodeQuotedPrintable(byte[])	org.apache.commons.codec.net.Utils.digit16(byte)
org.apache.commons.codec.language.DoubleMetaphone.handleC(String,DoubleMetaphoneResult,int)	org.apache.commons.codec.language.DoubleMetaphone.contains(String,int,int,String)
org.apache.commons.codec.digest.DigestUtils.sha256Hex(String)	org.apache.commons.codec.binary.Hex.encodeHex(byte[])
org.apache.commons.codec.language.Soundex.map(char)	org.apache.commons.codec.language.Soundex.getSoundexMapping()
org.apache.commons.codec.net.URLCodecTest.testDecodeObjects()	org.apache.commons.codec.net.URLCodec.decode(Object)
org.apache.commons.codec.language.DoubleMetaphone.conditionCH0(String,int)	org.apache.commons.codec.language.DoubleMetaphone.contains(String,int,int,String)
org.apache.commons.codec.net.URLCodecTest.testEncodeUrlWithNullBitSet()	org.apache.commons.codec.net.URLCodec.decode(String)
org.apache.commons.codec.language.DoubleMetaphone.DoubleMetaphoneResult.append(String,String)	org.apache.commons.codec.language.DoubleMetaphone.DoubleMetaphoneResult.appendPrimary(String)
org.apache.commons.codec.net.URLCodec.encode(String)	org.apache.commons.codec.net.URLCodec.encode(String,String)
org.apache.commons.codec.binary.Base64InputStreamTest.testReadNull()	org.apache.commons.codec.binary.Base64InputStream.read(byte[],int,int)
org.apache.commons.codec.binary.Base64InputStreamTest.testRead0()	org.apache.commons.codec.binary.StringBytesUtils.getBytesUtf8(String)
org.apache.commons.codec.binary.StringBytesUtils.getBytesUtf16(String)	org.apache.commons.codec.binary.StringBytesUtils.getSupportedBytes(String,String)
org.apache.commons.codec.binary.Base64InputStreamTest.testRead0()	org.apache.commons.codec.binary.Base64InputStream.read(byte[],int,int)
org.apache.commons.codec.net.BCodecTest.testUTF8RoundTrip()	org.apache.commons.codec.net.BCodecTest.constructString(int[])
org.apache.commons.codec.digest.DigestUtils.sha256Hex(String)	org.apache.commons.codec.digest.DigestUtils.sha256(String)
org.apache.commons.codec.language.DoubleMetaphone.conditionL0(String,int)	org.apache.commons.codec.language.DoubleMetaphone.contains(String,int,int,String,String)
org.apache.commons.codec.net.QCodecTest.testLetUsMakeCloverHappy()	org.apache.commons.codec.net.QCodec.setEncodeBlanks(boolean)
org.apache.commons.codec.net.QuotedPrintableCodecTest.testEncodeUrlWithNullBitSet()	org.apache.commons.codec.net.QuotedPrintableCodec.decode(String)
org.apache.commons.codec.binary.BinaryCodecTest.testToAsciiChars()	org.apache.commons.codec.binary.BinaryCodec.toAsciiChars(byte[])
org.apache.commons.codec.net.URLCodecTest.testBasicEncodeDecode()	org.apache.commons.codec.net.URLCodecTest.validateState(URLCodec)
org.apache.commons.codec.binary.Base64InputStreamTest.testReadOutOfBounds()	org.apache.commons.codec.binary.Base64InputStream.read(byte[],int,int)
org.apache.commons.codec.net.URLCodec.encode(String)	org.apache.commons.codec.net.URLCodec.getDefaultCharset()
org.apache.commons.codec.net.URLCodec.encode(Object)	org.apache.commons.codec.net.URLCodec.encode(String)
org.apache.commons.codec.net.RFC1522CodecTest.testNullInput()	org.apache.commons.codec.net.RFC1522Codec.encodeText(String,String)
org.apache.commons.codec.binary.Base64.encodeBase64(byte[])	org.apache.commons.codec.binary.Base64.encodeBase64(byte[],boolean)
org.apache.commons.codec.language.DoubleMetaphone.handleSC(String,DoubleMetaphoneResult,int)	org.apache.commons.codec.language.DoubleMetaphone.charAt(String,int)
org.apache.commons.codec.digest.DigestUtils.getSha512Digest()	org.apache.commons.codec.digest.DigestUtils.getDigest(String)
org.apache.commons.codec.digest.DigestUtilsTest.testMd5Hex()	org.apache.commons.codec.digest.DigestUtils.md5Hex(String)
org.apache.commons.codec.language.DoubleMetaphone.handleSC(String,DoubleMetaphoneResult,int)	org.apache.commons.codec.language.DoubleMetaphone.contains(String,int,int,String,String,String)
org.apache.commons.codec.digest.DigestUtils.sha256(byte[])	org.apache.commons.codec.digest.DigestUtils.getSha256Digest()
org.apache.commons.codec.language.DoubleMetaphone.handleG(String,DoubleMetaphoneResult,int,boolean)	org.apache.commons.codec.language.DoubleMetaphone.contains(String,int,int,String)
org.apache.commons.codec.binary.Base64OutputStreamTest.testBase64OutputStreamByteByByte()	org.apache.commons.codec.binary.Base64TestData.randomData(int,boolean)
org.apache.commons.codec.binary.Base64Test.testIsUrlSafe()	org.apache.commons.codec.binary.Base64.isArrayByteBase64(byte[])
org.apache.commons.codec.net.QCodecTest.testInvalidEncoding()	org.apache.commons.codec.net.QCodec.encode(String)
org.apache.commons.codec.StringEncoderAbstractTest.testLocaleIndependence()	org.apache.commons.codec.StringEncoderAbstractTest.makeEncoder()
org.apache.commons.codec.language.DoubleMetaphone.conditionC0(String,int)	org.apache.commons.codec.language.DoubleMetaphone.isVowel(char)
org.apache.commons.codec.digest.DigestUtils.shaHex(String)	org.apache.commons.codec.digest.DigestUtils.sha(String)
org.apache.commons.codec.binary.Base64Test.testEncodeOverMaxSize()	org.apache.commons.codec.binary.Base64Test.testEncodeOverMaxSize(int)
org.apache.commons.codec.binary.Base64.decodeBase64(byte[])	org.apache.commons.codec.binary.Base64.readResults(byte[],int,int)
org.apache.commons.codec.binary.Base64Test.testBase64()	org.apache.commons.codec.binary.Base64.encodeBase64(byte[])
org.apache.commons.codec.language.DoubleMetaphone.handleJ(String,DoubleMetaphoneResult,int,boolean)	org.apache.commons.codec.language.DoubleMetaphone.DoubleMetaphoneResult.append(char,char)
org.apache.commons.codec.net.QCodecTest.testNullInput()	org.apache.commons.codec.net.QCodec.doEncoding(byte[])
org.apache.commons.codec.binary.StringBytesUtils.getBytesUtf16Be(String)	org.apache.commons.codec.binary.StringBytesUtils.getSupportedBytes(String,String)
org.apache.commons.codec.net.URLCodecTest.testDefaultEncoding()	org.apache.commons.codec.net.URLCodec.encode(String)
org.apache.commons.codec.net.QuotedPrintableCodecTest.testDecodeObjects()	org.apache.commons.codec.net.QuotedPrintableCodec.decode(Object)
org.apache.commons.codec.language.DoubleMetaphone.doubleMetaphone(String,boolean)	org.apache.commons.codec.language.DoubleMetaphone.handleD(String,DoubleMetaphoneResult,int)
org.apache.commons.codec.language.DoubleMetaphone.DoubleMetaphoneResult.append(char)	org.apache.commons.codec.language.DoubleMetaphone.DoubleMetaphoneResult.appendAlternate(char)
org.apache.commons.codec.binary.StringBytesUtilsTest.testGetSupportedBytes(String)	org.apache.commons.codec.binary.StringBytesUtils.getSupportedBytes(String,String)
org.apache.commons.codec.digest.DigestUtils.shaHex(InputStream)	org.apache.commons.codec.digest.DigestUtils.sha(InputStream)
org.apache.commons.codec.net.QCodecTest.testLetUsMakeCloverHappy()	org.apache.commons.codec.net.QCodec.isEncodeBlanks()
org.apache.commons.codec.binary.HexTest.testDecodeClassCastException()	org.apache.commons.codec.binary.Hex.decode(Object)
org.apache.commons.codec.language.SoundexTest.testNewInstance()	org.apache.commons.codec.language.Soundex.soundex(String)
org.apache.commons.codec.net.QuotedPrintableCodec.encode(Object)	org.apache.commons.codec.net.QuotedPrintableCodec.encode(String)
org.apache.commons.codec.language.Soundex.soundex(String)	org.apache.commons.codec.language.SoundexUtils.clean(String)
org.apache.commons.codec.binary.HexTest.testEncodeDecodeRandom()	org.apache.commons.codec.binary.Hex.encode(Object)
org.apache.commons.codec.digest.DigestUtils.md5Hex(String)	org.apache.commons.codec.binary.Hex.encodeHex(byte[])
org.apache.commons.codec.binary.Base64.decode(byte[],int,int)	org.apache.commons.codec.binary.Base64.resizeBuffer()
org.apache.commons.codec.net.QuotedPrintableCodec.encodeQuotedPrintable(BitSet,byte[])	org.apache.commons.codec.net.QuotedPrintableCodec.encodeQuotedPrintable(int,ByteArrayOutputStream)
org.apache.commons.codec.binary.HexTest.testDecodeStringOddCharacters()	org.apache.commons.codec.binary.Hex.decode(Object)
org.apache.commons.codec.net.URLCodecTest.testSafeCharEncodeDecode()	org.apache.commons.codec.net.URLCodecTest.validateState(URLCodec)
org.apache.commons.codec.language.DoubleMetaphone.handleC(String,DoubleMetaphoneResult,int)	org.apache.commons.codec.language.DoubleMetaphone.conditionC0(String,int)
org.apache.commons.codec.language.DoubleMetaphone.contains(String,int,int,String,String,String,String,String,String)	org.apache.commons.codec.language.DoubleMetaphone.contains(String,int,int,String[])
org.apache.commons.codec.binary.StringBytesUtils.newString(byte[],String)	org.apache.commons.codec.binary.StringBytesUtils.newIllegalStateException(String,UnsupportedEncodingException)
org.apache.commons.codec.language.DoubleMetaphone.handleCC(String,DoubleMetaphoneResult,int)	org.apache.commons.codec.language.DoubleMetaphone.contains(String,int,int,String)
org.apache.commons.codec.language.DoubleMetaphone.handleD(String,DoubleMetaphoneResult,int)	org.apache.commons.codec.language.DoubleMetaphone.contains(String,int,int,String,String,String)
org.apache.commons.codec.binary.Base64OutputStream.flush()	org.apache.commons.codec.binary.Base64OutputStream.flush(boolean)
org.apache.commons.codec.binary.Base64InputStreamTest.testReadOutOfBounds()	org.apache.commons.codec.binary.StringBytesUtils.getBytesUtf8(String)
org.apache.commons.codec.binary.BinaryCodecTest.testToAsciiBytes()	org.apache.commons.codec.binary.BinaryCodec.toAsciiBytes(byte[])
org.apache.commons.codec.language.DoubleMetaphone.handleSC(String,DoubleMetaphoneResult,int)	org.apache.commons.codec.language.DoubleMetaphone.DoubleMetaphoneResult.append(String,String)
org.apache.commons.codec.language.DoubleMetaphone.doubleMetaphone(String,boolean)	org.apache.commons.codec.language.DoubleMetaphone.handleC(String,DoubleMetaphoneResult,int)
org.apache.commons.codec.language.DoubleMetaphone.doubleMetaphone(String,boolean)	org.apache.commons.codec.language.DoubleMetaphone.handleZ(String,DoubleMetaphoneResult,int,boolean)
org.apache.commons.codec.binary.Base64Test.testObjectDecodeWithValidParameter()	org.apache.commons.codec.binary.Base64.decode(Object)
org.apache.commons.codec.language.DoubleMetaphone.doubleMetaphone(String,boolean)	org.apache.commons.codec.language.DoubleMetaphone.handleR(String,DoubleMetaphoneResult,int,boolean)
org.apache.commons.codec.binary.Hex.encodeHex(byte[])	org.apache.commons.codec.binary.Hex.encodeHex(byte[],boolean)
org.apache.commons.codec.digest.DigestUtilsTest.testMD5Length()	org.apache.commons.codec.digest.DigestUtils.md5(byte[])
org.apache.commons.codec.binary.Base64InputStream.read(byte[],int,int)	org.apache.commons.codec.binary.Base64.readResults(byte[],int,int)
org.apache.commons.codec.language.DoubleMetaphone.handleSC(String,DoubleMetaphoneResult,int)	org.apache.commons.codec.language.DoubleMetaphone.isVowel(char)
org.apache.commons.codec.binary.Base64.decodeBase64(byte[])	org.apache.commons.codec.binary.Base64.setInitialBuffer(byte[],int,int)
org.apache.commons.codec.binary.Base64Test.testCodeInteger1()	org.apache.commons.codec.binary.Base64.decodeInteger(byte[])
org.apache.commons.codec.binary.StringBytesUtilsTest.testNewStringUsAscii()	org.apache.commons.codec.binary.StringBytesUtils.newStringUsAscii(byte[])
org.apache.commons.codec.binary.HexTest.testDencodeEmpty()	org.apache.commons.codec.binary.Hex.decodeHex(char[])
org.apache.commons.codec.net.QuotedPrintableCodecTest.testEncodeDecodeNull()	org.apache.commons.codec.net.QuotedPrintableCodec.encode(String)
org.apache.commons.codec.digest.DigestUtils.getMd5Digest()	org.apache.commons.codec.digest.DigestUtils.getDigest(String)
org.apache.commons.codec.StringEncoderComparator.compare(Object,Object)	org.apache.commons.codec.Encoder.encode(Object)
org.apache.commons.codec.net.QuotedPrintableCodecTest.testSafeCharEncodeDecode()	org.apache.commons.codec.net.QuotedPrintableCodec.encode(String)
org.apache.commons.codec.net.QCodec.decode(String)	org.apache.commons.codec.net.RFC1522Codec.decodeText(String)
org.apache.commons.codec.binary.StringBytesUtilsTest.testNewStringIso8859_1()	org.apache.commons.codec.binary.StringBytesUtilsTest.testNewString(String)
org.apache.commons.codec.language.DoubleMetaphone.handleS(String,DoubleMetaphoneResult,int,boolean)	org.apache.commons.codec.language.DoubleMetaphone.contains(String,int,int,String)
org.apache.commons.codec.binary.Base64TestData.randomData(int,boolean)	org.apache.commons.codec.binary.Base64.encodeBase64URLSafe(byte[])
org.apache.commons.codec.language.DoubleMetaphone.handleS(String,DoubleMetaphoneResult,int,boolean)	org.apache.commons.codec.language.DoubleMetaphone.contains(String,int,int,String,String)
org.apache.commons.codec.net.URLCodecTest.testBasicEncodeDecode()	org.apache.commons.codec.net.URLCodec.encode(String)
org.apache.commons.codec.binary.Base64.encodeInteger(BigInteger)	org.apache.commons.codec.binary.Base64.toIntegerBytes(BigInteger)
org.apache.commons.codec.StringEncoderAbstractTest.testEncodeNull()	org.apache.commons.codec.StringEncoderAbstractTest.makeEncoder()
org.apache.commons.codec.binary.Base64Test.testUrlSafe()	org.apache.commons.codec.binary.Base64TestData.bytesContain(byte[],byte)
org.apache.commons.codec.binary.StringBytesUtilsTest.testNewStringUtf8()	org.apache.commons.codec.binary.StringBytesUtils.newStringUtf8(byte[])
org.apache.commons.codec.binary.Base64.encode(byte[],int,int)	org.apache.commons.codec.binary.Base64.resizeBuffer()
org.apache.commons.codec.net.URLCodecTest.testDecodeInvalid()	org.apache.commons.codec.net.URLCodecTest.validateState(URLCodec)
org.apache.commons.codec.binary.BinaryCodecTest.testEncodeObject()	org.apache.commons.codec.binary.BinaryCodec.encode(Object)
org.apache.commons.codec.language.DoubleMetaphone.conditionL0(String,int)	org.apache.commons.codec.language.DoubleMetaphone.contains(String,int,int,String,String,String)
org.apache.commons.codec.language.DoubleMetaphone.doubleMetaphone(String,boolean)	org.apache.commons.codec.language.DoubleMetaphone.handleL(String,DoubleMetaphoneResult,int)
org.apache.commons.codec.binary.HexTest.testEncodeDecodeRandom()	org.apache.commons.codec.binary.Hex.encodeHex(byte[])
org.apache.commons.codec.net.BCodec.encode(String,String)	org.apache.commons.codec.net.RFC1522Codec.encodeText(String,String)
org.apache.commons.codec.binary.Base64Test.testKnownDecodings()	org.apache.commons.codec.binary.Base64.decodeBase64(byte[])
org.apache.commons.codec.binary.StringBytesUtilsTest.testGetBytesIso8859_1()	org.apache.commons.codec.binary.StringBytesUtils.getBytesIso8859_1(String)
org.apache.commons.codec.language.Metaphone.metaphone(String)	org.apache.commons.codec.language.Metaphone.isLastChar(int,int)
org.apache.commons.codec.digest.DigestUtils.shaHex(byte[])	org.apache.commons.codec.digest.DigestUtils.sha(byte[])
org.apache.commons.codec.digest.DigestUtils.sha384(InputStream)	org.apache.commons.codec.digest.DigestUtils.digest(MessageDigest,InputStream)
org.apache.commons.codec.language.RefinedSoundex.soundex(String)	org.apache.commons.codec.language.SoundexUtils.clean(String)
org.apache.commons.codec.binary.Base64OutputStream.write(byte[],int,int)	org.apache.commons.codec.binary.Base64.encode(byte[],int,int)
org.apache.commons.codec.binary.Base64Test.testPairs()	org.apache.commons.codec.binary.Base64.encodeBase64(byte[])
org.apache.commons.codec.digest.DigestUtils.getSha384Digest()	org.apache.commons.codec.digest.DigestUtils.getDigest(String)
org.apache.commons.codec.language.SoundexTest.testMaxLengthLessThan3Fix()	org.apache.commons.codec.language.Soundex.setMaxLength(int)
org.apache.commons.codec.net.QuotedPrintableCodecTest.testDecodeStringWithNull()	org.apache.commons.codec.net.QuotedPrintableCodec.decode(String,String)
org.apache.commons.codec.binary.Base64.encodeBase64(byte[],boolean,boolean,int)	org.apache.commons.codec.binary.Base64.readResults(byte[],int,int)
org.apache.commons.codec.net.QCodec.encode(String,String)	org.apache.commons.codec.net.RFC1522Codec.encodeText(String,String)
org.apache.commons.codec.net.URLCodecTest.testSafeCharEncodeDecode()	org.apache.commons.codec.net.URLCodec.decode(String)
org.apache.commons.codec.language.DoubleMetaphone.isDoubleMetaphoneEqual(String,String)	org.apache.commons.codec.language.DoubleMetaphone.isDoubleMetaphoneEqual(String,String,boolean)
org.apache.commons.codec.language.DoubleMetaphone.handleC(String,DoubleMetaphoneResult,int)	org.apache.commons.codec.language.DoubleMetaphone.contains(String,int,int,String,String)
org.apache.commons.codec.binary.StringBytesUtilsTest.testGetBytesUtf8()	org.apache.commons.codec.binary.StringBytesUtils.getBytesUtf8(String)
org.apache.commons.codec.language.RefinedSoundexTest.testNewInstance()	org.apache.commons.codec.language.RefinedSoundex.soundex(String)
org.apache.commons.codec.binary.Base64InputStream.read(byte[],int,int)	org.apache.commons.codec.binary.Base64.setInitialBuffer(byte[],int,int)
org.apache.commons.codec.binary.Base64InputStreamTest.testBase64InputStreamByChunk()	org.apache.commons.codec.binary.Base64InputStreamTest.testByChunk(byte[],byte[],int,byte[])
org.apache.commons.codec.digest.DigestUtils.md5(InputStream)	org.apache.commons.codec.digest.DigestUtils.digest(MessageDigest,InputStream)
org.apache.commons.codec.language.DoubleMetaphone.handleSC(String,DoubleMetaphoneResult,int)	org.apache.commons.codec.language.DoubleMetaphone.DoubleMetaphoneResult.append(String)
org.apache.commons.codec.language.DoubleMetaphone.handleP(String,DoubleMetaphoneResult,int)	org.apache.commons.codec.language.DoubleMetaphone.contains(String,int,int,String,String)
org.apache.commons.codec.language.DoubleMetaphone.handleG(String,DoubleMetaphoneResult,int,boolean)	org.apache.commons.codec.language.DoubleMetaphone.handleGH(String,DoubleMetaphoneResult,int)
org.apache.commons.codec.binary.HexTest.testDencodeEmpty()	org.apache.commons.codec.binary.Hex.decode(Object)
org.apache.commons.codec.language.DoubleMetaphone.handleC(String,DoubleMetaphoneResult,int)	org.apache.commons.codec.language.DoubleMetaphone.handleCH(String,DoubleMetaphoneResult,int)
org.apache.commons.codec.language.DoubleMetaphone.handleL(String,DoubleMetaphoneResult,int)	org.apache.commons.codec.language.DoubleMetaphone.DoubleMetaphoneResult.appendAlternate(char)
org.apache.commons.codec.binary.Hex.decodeHex(char[])	org.apache.commons.codec.binary.Hex.toDigit(char,int)
org.apache.commons.codec.binary.Base64TestData.streamToBytes(InputStream)	org.apache.commons.codec.binary.Base64TestData.resizeArray(byte[])
org.apache.commons.codec.digest.DigestUtils.sha512Hex(String)	org.apache.commons.codec.binary.Hex.encodeHex(byte[])
org.apache.commons.codec.language.DoubleMetaphone.handleJ(String,DoubleMetaphoneResult,int,boolean)	org.apache.commons.codec.language.DoubleMetaphone.isVowel(char)
org.apache.commons.codec.binary.StringBytesUtils.newStringUsAscii(byte[])	org.apache.commons.codec.binary.StringBytesUtils.newString(byte[],String)
org.apache.commons.codec.binary.Base64OutputStreamTest.testBase64OutputStreamByChunk()	org.apache.commons.codec.binary.Base64OutputStreamTest.testByChunk(byte[],byte[],int,byte[])
org.apache.commons.codec.language.DoubleMetaphone.doubleMetaphone(String,boolean)	org.apache.commons.codec.language.DoubleMetaphone.handleW(String,DoubleMetaphoneResult,int)
org.apache.commons.codec.language.Soundex.encode(String)	org.apache.commons.codec.language.Soundex.soundex(String)
org.apache.commons.codec.binary.HexTest.testEncodeDecodeRandom()	org.apache.commons.codec.binary.Hex.decode(Object)
org.apache.commons.codec.binary.Base64OutputStream.close()	org.apache.commons.codec.binary.Base64OutputStream.flush()
org.apache.commons.codec.digest.DigestUtils.sha384Hex(String)	org.apache.commons.codec.digest.DigestUtils.sha384(String)
org.apache.commons.codec.digest.DigestUtils.sha256(String)	org.apache.commons.codec.digest.DigestUtils.sha256(byte[])
org.apache.commons.codec.digest.DigestUtils.sha384(byte[])	org.apache.commons.codec.digest.DigestUtils.getSha384Digest()
org.apache.commons.codec.language.DoubleMetaphone.doubleMetaphone(String,boolean)	org.apache.commons.codec.language.DoubleMetaphone.conditionM0(String,int)
org.apache.commons.codec.language.DoubleMetaphone.contains(String,int,int,String,String,String,String)	org.apache.commons.codec.language.DoubleMetaphone.contains(String,int,int,String[])
org.apache.commons.codec.StringEncoderAbstractTest.testEncodeEmpty()	org.apache.commons.codec.Encoder.encode(Object)
org.apache.commons.codec.net.URLCodec.decodeUrl(byte[])	org.apache.commons.codec.net.Utils.digit16(byte)
org.apache.commons.codec.language.DoubleMetaphone.doubleMetaphone(String,boolean)	org.apache.commons.codec.language.DoubleMetaphone.DoubleMetaphoneResult.getAlternate()
org.apache.commons.codec.net.QCodecTest.testBasicEncodeDecode()	org.apache.commons.codec.net.QCodec.decode(String)
org.apache.commons.codec.binary.Base64Test.testDecodePadMarkerIndex3()	org.apache.commons.codec.binary.Base64.decodeBase64(byte[])
org.apache.commons.codec.net.QCodecTest.testInvalidEncoding()	org.apache.commons.codec.net.QCodec.decode(String)
org.apache.commons.codec.language.DoubleMetaphone.handleR(String,DoubleMetaphoneResult,int,boolean)	org.apache.commons.codec.language.DoubleMetaphone.contains(String,int,int,String,String)
org.apache.commons.codec.net.QuotedPrintableCodecTest.testUTF8RoundTrip()	org.apache.commons.codec.net.QuotedPrintableCodec.encode(String,String)
org.apache.commons.codec.net.BCodecTest.testNullInput()	org.apache.commons.codec.net.BCodec.doDecoding(byte[])
org.apache.commons.codec.language.DoubleMetaphone.handleG(String,DoubleMetaphoneResult,int,boolean)	org.apache.commons.codec.language.DoubleMetaphone.DoubleMetaphoneResult.append(String,String)
org.apache.commons.codec.net.URLCodecTest.testDecodeStringWithNull()	org.apache.commons.codec.net.URLCodec.decode(String,String)
org.apache.commons.codec.binary.Base64.decode(Object)	org.apache.commons.codec.binary.Base64.decode(byte[])
org.apache.commons.codec.binary.Base64InputStreamTest.testReadNull()	org.apache.commons.codec.binary.StringBytesUtils.getBytesUtf8(String)
org.apache.commons.codec.binary.Base64.encodeBase64Chunked(byte[])	org.apache.commons.codec.binary.Base64.encodeBase64(byte[],boolean)
org.apache.commons.codec.digest.DigestUtils.sha384Hex(InputStream)	org.apache.commons.codec.digest.DigestUtils.sha384(InputStream)
org.apache.commons.codec.language.Metaphone.encode(String)	org.apache.commons.codec.language.Metaphone.metaphone(String)
org.apache.commons.codec.binary.Base64Test.testObjectEncodeWithValidParameter()	org.apache.commons.codec.binary.Base64.encode(Object)
org.apache.commons.codec.binary.BinaryCodecTest.testToAsciiString()	org.apache.commons.codec.binary.BinaryCodec.toAsciiString(byte[])
org.apache.commons.codec.binary.Base64InputStreamTest.testBase64InputStreamByteByByte()	org.apache.commons.codec.binary.Base64TestData.randomData(int,boolean)
org.apache.commons.codec.binary.HexTest.testDecodeHexOddCharacters()	org.apache.commons.codec.binary.Hex.decodeHex(char[])
org.apache.commons.codec.net.RFC1522Codec.encodeText(String,String)	org.apache.commons.codec.binary.StringBytesUtils.newStringUsAscii(byte[])
org.apache.commons.codec.binary.StringBytesUtilsTest.testNewStringUtf16()	org.apache.commons.codec.binary.StringBytesUtilsTest.testNewString(String)
org.apache.commons.codec.binary.Base64OutputStream.flush(boolean)	org.apache.commons.codec.binary.Base64.readResults(byte[],int,int)
org.apache.commons.codec.language.DoubleMetaphone.handleL(String,DoubleMetaphoneResult,int)	org.apache.commons.codec.language.DoubleMetaphone.charAt(String,int)
org.apache.commons.codec.digest.DigestUtilsTest.testShaHex()	org.apache.commons.codec.digest.DigestUtils.shaHex(String)
org.apache.commons.codec.binary.Base64.encode(byte[])	org.apache.commons.codec.binary.Base64.encodeBase64(byte[],boolean,boolean)
org.apache.commons.codec.net.QuotedPrintableCodecTest.testEncodeDecodeNull()	org.apache.commons.codec.net.QuotedPrintableCodec.decode(String)
org.apache.commons.codec.language.DoubleMetaphone.handleT(String,DoubleMetaphoneResult,int)	org.apache.commons.codec.language.DoubleMetaphone.DoubleMetaphoneResult.append(char)
org.apache.commons.codec.language.Metaphone.metaphone(String)	org.apache.commons.codec.language.Metaphone.isPreviousChar(StringBuffer,int,char)
org.apache.commons.codec.binary.Base64OutputStreamTest.testWriteToNullCoverage()	org.apache.commons.codec.binary.Base64OutputStream.write(byte[],int,int)
org.apache.commons.codec.language.DoubleMetaphone.contains(String,int,int,String,String,String)	org.apache.commons.codec.language.DoubleMetaphone.contains(String,int,int,String[])
org.apache.commons.codec.binary.Base64.encode(Object)	org.apache.commons.codec.binary.Base64.encode(byte[])
org.apache.commons.codec.BinaryEncoderAbstractTest.testEncodeEmpty()	org.apache.commons.codec.BinaryEncoder.encode(byte[])
org.apache.commons.codec.language.DoubleMetaphone.handleD(String,DoubleMetaphoneResult,int)	org.apache.commons.codec.language.DoubleMetaphone.contains(String,int,int,String)
org.apache.commons.codec.digest.DigestUtils.sha256Hex(InputStream)	org.apache.commons.codec.digest.DigestUtils.sha256(InputStream)
org.apache.commons.codec.net.QCodecTest.testEncodeDecodeBlanks()	org.apache.commons.codec.net.QCodec.encode(String)
org.apache.commons.codec.language.DoubleMetaphone.handleR(String,DoubleMetaphoneResult,int,boolean)	org.apache.commons.codec.language.DoubleMetaphone.charAt(String,int)
org.apache.commons.codec.language.DoubleMetaphone.handleG(String,DoubleMetaphoneResult,int,boolean)	org.apache.commons.codec.language.DoubleMetaphone.isVowel(char)
org.apache.commons.codec.language.DoubleMetaphone.handleCH(String,DoubleMetaphoneResult,int)	org.apache.commons.codec.language.DoubleMetaphone.DoubleMetaphoneResult.append(char)
org.apache.commons.codec.net.QuotedPrintableCodecTest.testSafeCharEncodeDecode()	org.apache.commons.codec.net.QuotedPrintableCodec.decode(String)
org.apache.commons.codec.language.DoubleMetaphone.handleSC(String,DoubleMetaphoneResult,int)	org.apache.commons.codec.language.DoubleMetaphone.DoubleMetaphoneResult.append(char)
org.apache.commons.codec.net.URLCodecTest.testBasicEncodeDecode()	org.apache.commons.codec.net.URLCodec.decode(String)
org.apache.commons.codec.binary.Base64Test.testCodeIntegerNull()	org.apache.commons.codec.binary.Base64.encodeInteger(BigInteger)
org.apache.commons.codec.language.DoubleMetaphone.handleW(String,DoubleMetaphoneResult,int)	org.apache.commons.codec.language.DoubleMetaphone.contains(String,int,int,String,String)
org.apache.commons.codec.language.DoubleMetaphone.handleG(String,DoubleMetaphoneResult,int,boolean)	org.apache.commons.codec.language.DoubleMetaphone.contains(String,int,int,String,String,String)
org.apache.commons.codec.binary.StringBytesUtilsTest.testNewStringUtf16Le()	org.apache.commons.codec.binary.StringBytesUtils.newStringUtf16Le(byte[])
org.apache.commons.codec.digest.DigestUtils.sha512(byte[])	org.apache.commons.codec.digest.DigestUtils.getSha512Digest()
org.apache.commons.codec.digest.DigestUtils.sha512Hex(InputStream)	org.apache.commons.codec.binary.Hex.encodeHex(byte[])
org.apache.commons.codec.binary.Base64InputStreamTest.testMarkSupported()	org.apache.commons.codec.binary.StringBytesUtils.getBytesUtf8(String)
org.apache.commons.codec.language.DoubleMetaphone.handleG(String,DoubleMetaphoneResult,int,boolean)	org.apache.commons.codec.language.DoubleMetaphone.DoubleMetaphoneResult.append(char,char)
org.apache.commons.codec.binary.Base64InputStreamTest.testBase64InputStreamByteByByte()	org.apache.commons.codec.binary.Base64InputStreamTest.testByteByByte(byte[],byte[],int,byte[])
org.apache.commons.codec.digest.DigestUtilsTest.testSha256()	org.apache.commons.codec.digest.DigestUtils.sha256Hex(byte[])
org.apache.commons.codec.binary.Base64.encodeBase64(byte[],boolean)	org.apache.commons.codec.binary.Base64.encodeBase64(byte[],boolean,boolean)
org.apache.commons.codec.digest.DigestUtils.sha(byte[])	org.apache.commons.codec.digest.DigestUtils.getShaDigest()
org.apache.commons.codec.digest.DigestUtils.shaHex(byte[])	org.apache.commons.codec.binary.Hex.encodeHex(byte[])
org.apache.commons.codec.binary.HexTest.testDecodeBadCharacterPos1()	org.apache.commons.codec.binary.Hex.decode(Object)
org.apache.commons.codec.digest.DigestUtils.md5Hex(String)	org.apache.commons.codec.digest.DigestUtils.md5(String)
org.apache.commons.codec.language.SoundexUtils.difference(StringEncoder,String,String)	org.apache.commons.codec.language.SoundexUtils.differenceEncoded(String,String)
org.apache.commons.codec.binary.HexTest.testDencodeEmpty()	org.apache.commons.codec.binary.Hex.decode(byte[])
org.apache.commons.codec.net.QuotedPrintableCodecTest.testUnsafeEncodeDecode()	org.apache.commons.codec.net.QuotedPrintableCodec.encode(String)
org.apache.commons.codec.StringEncoderAbstractTest.testLocaleIndependence()	org.apache.commons.codec.StringEncoder.encode(String)
org.apache.commons.codec.language.Caverphone.encode(Object)	org.apache.commons.codec.language.Caverphone.caverphone(String)
org.apache.commons.codec.binary.Base64OutputStream.write(byte[],int,int)	org.apache.commons.codec.binary.Base64.decode(byte[],int,int)
org.apache.commons.codec.binary.Base64InputStream.read(byte[],int,int)	org.apache.commons.codec.binary.Base64.hasData()
org.apache.commons.codec.net.BCodecTest.testNullInput()	org.apache.commons.codec.net.BCodec.doEncoding(byte[])
org.apache.commons.codec.binary.BinaryCodec.encode(Object)	org.apache.commons.codec.binary.BinaryCodec.toAsciiChars(byte[])
org.apache.commons.codec.language.DoubleMetaphone.handleJ(String,DoubleMetaphoneResult,int,boolean)	org.apache.commons.codec.language.DoubleMetaphone.DoubleMetaphoneResult.append(char)
org.apache.commons.codec.binary.Base64Test.testDecodePadMarkerIndex2()	org.apache.commons.codec.binary.Base64.decodeBase64(byte[])
org.apache.commons.codec.binary.Base64OutputStream.write(byte[],int,int)	org.apache.commons.codec.binary.Base64OutputStream.flush(boolean)
org.apache.commons.codec.binary.BinaryCodec.decode(Object)	org.apache.commons.codec.binary.BinaryCodec.fromAscii(char[])
org.apache.commons.codec.net.QuotedPrintableCodec.decode(byte[])	org.apache.commons.codec.net.QuotedPrintableCodec.decodeQuotedPrintable(byte[])
org.apache.commons.codec.language.DoubleMetaphone.handleJ(String,DoubleMetaphoneResult,int,boolean)	org.apache.commons.codec.language.DoubleMetaphone.contains(String,int,int,String[])
org.apache.commons.codec.binary.Base64OutputStreamTest.testBase64EmptyOutputStream()	org.apache.commons.codec.binary.Base64OutputStreamTest.testByChunk(byte[],byte[],int,byte[])
org.apache.commons.codec.language.DoubleMetaphone.handleR(String,DoubleMetaphoneResult,int,boolean)	org.apache.commons.codec.language.DoubleMetaphone.contains(String,int,int,String)
org.apache.commons.codec.language.SoundexTest.testMaxLengthLessThan3Fix()	org.apache.commons.codec.language.Soundex.encode(String)
org.apache.commons.codec.language.DoubleMetaphone.handleD(String,DoubleMetaphoneResult,int)	org.apache.commons.codec.language.DoubleMetaphone.contains(String,int,int,String,String)
org.apache.commons.codec.binary.Base64Test.testCodeInteger2()	org.apache.commons.codec.binary.Base64.decodeInteger(byte[])
org.apache.commons.codec.net.BCodec.doDecoding(byte[])	org.apache.commons.codec.binary.Base64.decodeBase64(byte[])
org.apache.commons.codec.digest.DigestUtilsTest.testShaHex()	org.apache.commons.codec.digest.DigestUtils.shaHex(InputStream)
org.apache.commons.codec.binary.Base64.readResults(byte[],int,int)	org.apache.commons.codec.binary.Base64.avail()
org.apache.commons.codec.binary.Base64OutputStream.close()	org.apache.commons.codec.binary.Base64.decode(byte[],int,int)
org.apache.commons.codec.binary.StringBytesUtilsTest.testGetBytesUtf16Be()	org.apache.commons.codec.binary.StringBytesUtils.getBytesUtf16Be(String)
org.apache.commons.codec.binary.HexTest.testEncodeDecodeRandom()	org.apache.commons.codec.binary.Hex.decodeHex(char[])
org.apache.commons.codec.binary.HexTest.testHelloWorldUpperCaseHex()	org.apache.commons.codec.binary.Hex.encodeHex(byte[])
org.apache.commons.codec.binary.BinaryCodec.encode(byte[])	org.apache.commons.codec.binary.BinaryCodec.toAsciiBytes(byte[])
org.apache.commons.codec.digest.DigestUtilsTest.testInternalNoSuchAlgorithmException()	org.apache.commons.codec.digest.DigestUtils.getDigest(String)
org.apache.commons.codec.net.URLCodecTest.testDecodeInvalidContent()	org.apache.commons.codec.net.URLCodec.decode(byte[])
org.apache.commons.codec.net.URLCodecTest.testInvalidEncoding()	org.apache.commons.codec.net.URLCodecTest.validateState(URLCodec)
org.apache.commons.codec.language.SoundexTest.testSoundexUtilsNullBehaviour()	org.apache.commons.codec.language.SoundexUtils.clean(String)
org.apache.commons.codec.binary.Base64Test.testObjectEncodeWithValidParameter()	org.apache.commons.codec.binary.Base64.decodeBase64(byte[])
org.apache.commons.codec.binary.Base64OutputStream.close()	org.apache.commons.codec.binary.Base64.encode(byte[],int,int)
org.apache.commons.codec.binary.StringBytesUtils.getSupportedBytes(String,String)	org.apache.commons.codec.binary.StringBytesUtils.newIllegalStateException(String,UnsupportedEncodingException)
org.apache.commons.codec.language.DoubleMetaphone.conditionCH1(String,int)	org.apache.commons.codec.language.DoubleMetaphone.contains(String,int,int,String,String)
org.apache.commons.codec.net.RFC1522Codec.encodeText(String,String)	org.apache.commons.codec.net.RFC1522Codec.doEncoding(byte[])
org.apache.commons.codec.digest.DigestUtilsTest.testMd5Hex()	org.apache.commons.codec.digest.DigestUtils.md5Hex(byte[])
org.apache.commons.codec.language.DoubleMetaphone.conditionC0(String,int)	org.apache.commons.codec.language.DoubleMetaphone.contains(String,int,int,String)
org.apache.commons.codec.binary.HexTest.testEncodeDecodeRandom()	org.apache.commons.codec.binary.Hex.encode(byte[])
org.apache.commons.codec.binary.BinaryCodecTest.testDecodeObjectException()	org.apache.commons.codec.binary.BinaryCodec.decode(Object)
org.apache.commons.codec.binary.Base64.encode(byte[])	org.apache.commons.codec.binary.Base64.isUrlSafe()
org.apache.commons.codec.language.DoubleMetaphone.handleZ(String,DoubleMetaphoneResult,int,boolean)	org.apache.commons.codec.language.DoubleMetaphone.DoubleMetaphoneResult.append(String,String)
org.apache.commons.codec.net.QuotedPrintableCodecTest.testBasicEncodeDecode()	org.apache.commons.codec.net.QuotedPrintableCodec.decode(String)
org.apache.commons.codec.digest.DigestUtils.sha384(InputStream)	org.apache.commons.codec.digest.DigestUtils.getSha384Digest()
org.apache.commons.codec.language.SoundexTest.testMaxLength()	org.apache.commons.codec.language.Soundex.setMaxLength(int)
org.apache.commons.codec.net.QuotedPrintableCodec.decode(Object)	org.apache.commons.codec.net.QuotedPrintableCodec.decode(String)
org.apache.commons.codec.language.DoubleMetaphone.conditionM0(String,int)	org.apache.commons.codec.language.DoubleMetaphone.contains(String,int,int,String)
org.apache.commons.codec.binary.StringBytesUtilsTest.testNewString(String)	org.apache.commons.codec.binary.StringBytesUtils.newString(byte[],String)
org.apache.commons.codec.digest.DigestUtilsTest.testSha256()	org.apache.commons.codec.digest.DigestUtils.sha256Hex(String)
org.apache.commons.codec.binary.Base64Test.testEncodeDecodeSmall()	org.apache.commons.codec.binary.Base64.isArrayByteBase64(byte[])
org.apache.commons.codec.language.DoubleMetaphone.doubleMetaphone(String,boolean)	org.apache.commons.codec.language.DoubleMetaphone.charAt(String,int)
org.apache.commons.codec.binary.Base64Test.testEncodeDecodeSmall()	org.apache.commons.codec.binary.Base64.encodeBase64(byte[])
org.apache.commons.codec.binary.StringBytesUtils.getBytesUtf16Le(String)	org.apache.commons.codec.binary.StringBytesUtils.getSupportedBytes(String,String)
org.apache.commons.codec.language.DoubleMetaphone.doubleMetaphone(String,boolean)	org.apache.commons.codec.language.DoubleMetaphone.isSilentStart(String)
org.apache.commons.codec.binary.StringBytesUtilsTest.testGetBytesUtf16Le()	org.apache.commons.codec.binary.StringBytesUtils.getBytesUtf16Le(String)
org.apache.commons.codec.binary.Base64.encodeBase64(byte[],boolean,boolean)	org.apache.commons.codec.binary.Base64.encodeBase64(byte[],boolean,boolean,int)
org.apache.commons.codec.language.CaverphoneTest.testIsCaverphoneEquals()	org.apache.commons.codec.language.Caverphone.isCaverphoneEqual(String,String)
org.apache.commons.codec.language.DoubleMetaphone.handleH(String,DoubleMetaphoneResult,int)	org.apache.commons.codec.language.DoubleMetaphone.isVowel(char)
org.apache.commons.codec.net.QCodecTest.testUTF8RoundTrip()	org.apache.commons.codec.net.QCodec.encode(String)
org.apache.commons.codec.BinaryEncoderAbstractTest.testEncodeNull()	org.apache.commons.codec.BinaryEncoderAbstractTest.makeEncoder()
org.apache.commons.codec.net.QuotedPrintableCodec.decode(String)	org.apache.commons.codec.net.QuotedPrintableCodec.getDefaultCharset()
org.apache.commons.codec.language.RefinedSoundexTest.testNewInstance3()	org.apache.commons.codec.language.RefinedSoundex.soundex(String)
org.apache.commons.codec.net.BCodecTest.testDecodeStringWithNull()	org.apache.commons.codec.net.BCodec.decode(String)
org.apache.commons.codec.digest.DigestUtils.md5(String)	org.apache.commons.codec.digest.DigestUtils.md5(byte[])
org.apache.commons.codec.digest.DigestUtils.sha512Hex(String)	org.apache.commons.codec.digest.DigestUtils.sha512(String)
org.apache.commons.codec.net.RFC1522Codec.decodeText(String)	org.apache.commons.codec.net.RFC1522Codec.doDecoding(byte[])
org.apache.commons.codec.net.QCodecTest.testDecodeObjects()	org.apache.commons.codec.net.QCodec.decode(Object)
org.apache.commons.codec.binary.StringBytesUtils.getBytesUtf8(String)	org.apache.commons.codec.binary.StringBytesUtils.getSupportedBytes(String,String)
org.apache.commons.codec.language.DoubleMetaphone.conditionCH1(String,int)	org.apache.commons.codec.language.DoubleMetaphone.contains(String,int,int,String[])
org.apache.commons.codec.language.DoubleMetaphone.doubleMetaphone(String,boolean)	org.apache.commons.codec.language.DoubleMetaphone.DoubleMetaphoneResult.isComplete()
org.apache.commons.codec.net.BCodecTest.testUTF8RoundTrip()	org.apache.commons.codec.net.BCodec.encode(String)
org.apache.commons.codec.net.BCodecTest.testDecodeObjects()	org.apache.commons.codec.net.BCodec.decode(Object)
org.apache.commons.codec.language.DoubleMetaphone.DoubleMetaphoneResult.append(String,String)	org.apache.commons.codec.language.DoubleMetaphone.DoubleMetaphoneResult.appendAlternate(String)
org.apache.commons.codec.net.URLCodecTest.testDefaultEncoding()	org.apache.commons.codec.net.URLCodec.encode(String,String)
org.apache.commons.codec.digest.DigestUtils.sha384Hex(byte[])	org.apache.commons.codec.binary.Hex.encodeHex(byte[])
org.apache.commons.codec.language.DoubleMetaphone.isDoubleMetaphoneEqual(String,String,boolean)	org.apache.commons.codec.language.DoubleMetaphone.doubleMetaphone(String,boolean)
org.apache.commons.codec.language.DoubleMetaphone.handleZ(String,DoubleMetaphoneResult,int,boolean)	org.apache.commons.codec.language.DoubleMetaphone.contains(String,int,int,String,String,String)
org.apache.commons.codec.StringEncoderAbstractTest.testEncodeWithInvalidObject()	org.apache.commons.codec.StringEncoderAbstractTest.makeEncoder()
org.apache.commons.codec.digest.DigestUtils.sha512(InputStream)	org.apache.commons.codec.digest.DigestUtils.getSha512Digest()
org.apache.commons.codec.language.DoubleMetaphone.handleW(String,DoubleMetaphoneResult,int)	org.apache.commons.codec.language.DoubleMetaphone.DoubleMetaphoneResult.append(String,String)
org.apache.commons.codec.binary.Base64Test.testUUID()	org.apache.commons.codec.binary.Base64.encodeBase64URLSafe(byte[])
org.apache.commons.codec.binary.BinaryCodecTest.testEncodeObjectNull()	org.apache.commons.codec.binary.BinaryCodec.encode(Object)
org.apache.commons.codec.binary.Base64OutputStream.write(int)	org.apache.commons.codec.binary.Base64OutputStream.write(byte[],int,int)
org.apache.commons.codec.net.RFC1522CodecTest.testDecodeInvalid()	org.apache.commons.codec.net.RFC1522Codec.decodeText(String)
org.apache.commons.codec.net.BCodecTest.testEncodeObjects()	org.apache.commons.codec.net.BCodec.encode(Object)
org.apache.commons.codec.binary.BinaryCodec.decode(Object)	org.apache.commons.codec.binary.BinaryCodec.fromAscii(byte[])
org.apache.commons.codec.language.DoubleMetaphone.handleCC(String,DoubleMetaphoneResult,int)	org.apache.commons.codec.language.DoubleMetaphone.charAt(String,int)
org.apache.commons.codec.binary.Base64Test.testCodeInteger2()	org.apache.commons.codec.binary.Base64.encodeInteger(BigInteger)
org.apache.commons.codec.binary.HexTest.testEncodeClassCastException()	org.apache.commons.codec.binary.Hex.encode(Object)
org.apache.commons.codec.net.QCodecTest.testUTF8RoundTrip()	org.apache.commons.codec.net.QCodec.decode(String)
org.apache.commons.codec.digest.DigestUtils.sha256(InputStream)	org.apache.commons.codec.digest.DigestUtils.getSha256Digest()
org.apache.commons.codec.net.URLCodecTest.validateState(URLCodec)	org.apache.commons.codec.net.URLCodec.getEncoding()
org.apache.commons.codec.binary.HexTest.testHelloWorldLowerCaseHex()	org.apache.commons.codec.binary.Hex.encodeHex(byte[])
org.apache.commons.codec.net.QuotedPrintableCodec.encode(String,String)	org.apache.commons.codec.binary.StringBytesUtils.newStringUsAscii(byte[])
org.apache.commons.codec.binary.Base64OutputStreamTest.testWriteOutOfBounds()	org.apache.commons.codec.binary.Base64OutputStream.write(byte[],int,int)
org.apache.commons.codec.binary.Base64Test.testSingletons()	org.apache.commons.codec.binary.Base64.decodeBase64(byte[])
org.apache.commons.codec.binary.HexTest.testEncodeDecodeRandom()	org.apache.commons.codec.binary.Hex.decode(byte[])
org.apache.commons.codec.language.DoubleMetaphone.handleS(String,DoubleMetaphoneResult,int,boolean)	org.apache.commons.codec.language.DoubleMetaphone.DoubleMetaphoneResult.append(char,char)
org.apache.commons.codec.net.URLCodecTest.testUTF8RoundTrip()	org.apache.commons.codec.net.URLCodecTest.validateState(URLCodec)
org.apache.commons.codec.net.URLCodecTest.testUnsafeEncodeDecode()	org.apache.commons.codec.net.URLCodec.decode(String)
org.apache.commons.codec.net.BCodecTest.testInvalidEncoding()	org.apache.commons.codec.net.BCodec.encode(String)
org.apache.commons.codec.net.QuotedPrintableCodecTest.testEncodeUrlWithNullBitSet()	org.apache.commons.codec.net.QuotedPrintableCodec.encodeQuotedPrintable(BitSet,byte[])
org.apache.commons.codec.digest.DigestUtils.md5Hex(InputStream)	org.apache.commons.codec.digest.DigestUtils.md5(InputStream)
org.apache.commons.codec.language.DoubleMetaphone.handleGH(String,DoubleMetaphoneResult,int)	org.apache.commons.codec.language.DoubleMetaphone.charAt(String,int)
org.apache.commons.codec.language.DoubleMetaphone.handleG(String,DoubleMetaphoneResult,int,boolean)	org.apache.commons.codec.language.DoubleMetaphone.DoubleMetaphoneResult.append(String)
org.apache.commons.codec.language.DoubleMetaphone.conditionCH0(String,int)	org.apache.commons.codec.language.DoubleMetaphone.contains(String,int,int,String,String)
org.apache.commons.codec.BinaryEncoderAbstractTest.testEncodeEmpty()	org.apache.commons.codec.BinaryEncoderAbstractTest.makeEncoder()
org.apache.commons.codec.language.DoubleMetaphone.handleGH(String,DoubleMetaphoneResult,int)	org.apache.commons.codec.language.DoubleMetaphone.contains(String,int,int,String,String,String,String,String)
org.apache.commons.codec.language.DoubleMetaphone.conditionCH1(String,int)	org.apache.commons.codec.language.DoubleMetaphone.contains(String,int,int,String,String,String,String)
org.apache.commons.codec.binary.Base64Test.testEncodeDecodeSmall()	org.apache.commons.codec.binary.Base64.decodeBase64(byte[])
org.apache.commons.codec.binary.Base64Test.testUrlSafe()	org.apache.commons.codec.binary.Base64.decodeBase64(byte[])
org.apache.commons.codec.language.DoubleMetaphone.contains(String,int,int,String)	org.apache.commons.codec.language.DoubleMetaphone.contains(String,int,int,String[])
org.apache.commons.codec.binary.StringBytesUtils.getBytesIso8859_1(String)	org.apache.commons.codec.binary.StringBytesUtils.getSupportedBytes(String,String)
org.apache.commons.codec.binary.Base64Test.testTriplets()	org.apache.commons.codec.binary.Base64.encodeBase64(byte[])
org.apache.commons.codec.digest.DigestUtils.shaHex(InputStream)	org.apache.commons.codec.binary.Hex.encodeHex(byte[])
org.apache.commons.codec.net.QuotedPrintableCodecTest.testBasicEncodeDecode()	org.apache.commons.codec.net.QuotedPrintableCodec.encode(String)
org.apache.commons.codec.language.DoubleMetaphone.handleD(String,DoubleMetaphoneResult,int)	org.apache.commons.codec.language.DoubleMetaphone.DoubleMetaphoneResult.append(String)
org.apache.commons.codec.language.Metaphone.metaphone(String)	org.apache.commons.codec.language.Metaphone.isNextChar(StringBuffer,int,char)
org.apache.commons.codec.net.QCodecTest.testEncodeDecodeBlanks()	org.apache.commons.codec.net.QCodec.decode(String)
org.apache.commons.codec.language.DoubleMetaphone.handleH(String,DoubleMetaphoneResult,int)	org.apache.commons.codec.language.DoubleMetaphone.DoubleMetaphoneResult.append(char)
org.apache.commons.codec.binary.StringBytesUtilsTest.testGetBytesUsAscii()	org.apache.commons.codec.binary.StringBytesUtilsTest.testGetSupportedBytes(String)
org.apache.commons.codec.language.DoubleMetaphone.handleW(String,DoubleMetaphoneResult,int)	org.apache.commons.codec.language.DoubleMetaphone.contains(String,int,int,String)
org.apache.commons.codec.net.QuotedPrintableCodecTest.testEncodeNull()	org.apache.commons.codec.net.QuotedPrintableCodec.encode(byte[])
org.apache.commons.codec.digest.DigestUtils.sha256Hex(byte[])	org.apache.commons.codec.digest.DigestUtils.sha256(byte[])
org.apache.commons.codec.language.DoubleMetaphone.handleG(String,DoubleMetaphoneResult,int,boolean)	org.apache.commons.codec.language.DoubleMetaphone.charAt(String,int)
org.apache.commons.codec.language.DoubleMetaphone.handleC(String,DoubleMetaphoneResult,int)	org.apache.commons.codec.language.DoubleMetaphone.charAt(String,int)
org.apache.commons.codec.binary.Base64OutputStreamTest.testBase64OutputStreamByChunk()	org.apache.commons.codec.binary.StringBytesUtils.getBytesUtf8(String)
org.apache.commons.codec.language.DoubleMetaphone.handleW(String,DoubleMetaphoneResult,int)	org.apache.commons.codec.language.DoubleMetaphone.DoubleMetaphoneResult.append(char,char)
org.apache.commons.codec.net.QCodecTest.testEncodeDecodeNull()	org.apache.commons.codec.net.QCodec.encode(String)
org.apache.commons.codec.language.DoubleMetaphone.doubleMetaphone(String,boolean)	org.apache.commons.codec.language.DoubleMetaphone.handleS(String,DoubleMetaphoneResult,int,boolean)
org.apache.commons.codec.binary.StringBytesUtils.newStringUtf8(byte[])	org.apache.commons.codec.binary.StringBytesUtils.newString(byte[],String)
org.apache.commons.codec.language.SoundexTest.testSoundexUtilsNullBehaviour()	org.apache.commons.codec.language.SoundexUtils.differenceEncoded(String,String)
org.apache.commons.codec.language.RefinedSoundexTest.testNewInstance2()	org.apache.commons.codec.language.RefinedSoundex.soundex(String)
org.apache.commons.codec.language.DoubleMetaphone.handleR(String,DoubleMetaphoneResult,int,boolean)	org.apache.commons.codec.language.DoubleMetaphone.DoubleMetaphoneResult.appendAlternate(char)
org.apache.commons.codec.net.QCodec.doEncoding(byte[])	org.apache.commons.codec.net.QuotedPrintableCodec.encodeQuotedPrintable(BitSet,byte[])
org.apache.commons.codec.language.DoubleMetaphone.contains(String,int,int,String,String,String,String,String)	org.apache.commons.codec.language.DoubleMetaphone.contains(String,int,int,String[])
org.apache.commons.codec.binary.Base64Test.testCodeInteger4()	org.apache.commons.codec.binary.Base64.encodeInteger(BigInteger)
org.apache.commons.codec.binary.StringBytesUtilsTest.testGetBytesUtf8()	org.apache.commons.codec.binary.StringBytesUtilsTest.testGetSupportedBytes(String)
org.apache.commons.codec.language.DoubleMetaphone.handleG(String,DoubleMetaphoneResult,int,boolean)	org.apache.commons.codec.language.DoubleMetaphone.contains(String,int,int,String,String)
org.apache.commons.codec.digest.DigestUtils.sha256Hex(byte[])	org.apache.commons.codec.binary.Hex.encodeHex(byte[])
org.apache.commons.codec.language.DoubleMetaphone.doubleMetaphone(String,boolean)	org.apache.commons.codec.language.DoubleMetaphone.handleT(String,DoubleMetaphoneResult,int)
org.apache.commons.codec.binary.BinaryCodecTest.testFromAsciicharArray()	org.apache.commons.codec.binary.BinaryCodec.fromAscii(char[])
org.apache.commons.codec.language.DoubleMetaphone.handleC(String,DoubleMetaphoneResult,int)	org.apache.commons.codec.language.DoubleMetaphone.DoubleMetaphoneResult.append(char)
org.apache.commons.codec.net.URLCodecTest.testUTF8RoundTrip()	org.apache.commons.codec.net.URLCodec.encode(String,String)
org.apache.commons.codec.net.QCodecTest.testEncodeStringWithNull()	org.apache.commons.codec.net.QCodec.encode(String,String)
org.apache.commons.codec.digest.DigestUtilsTest.testSha384()	org.apache.commons.codec.digest.DigestUtils.sha384Hex(byte[])
org.apache.commons.codec.net.URLCodec.encode(String,String)	org.apache.commons.codec.net.URLCodec.encode(byte[])
org.apache.commons.codec.binary.Base64Test.testIsArrayByteBase64()	org.apache.commons.codec.binary.Base64.isArrayByteBase64(byte[])
org.apache.commons.codec.binary.Base64TestData.streamToBytes(InputStream)	org.apache.commons.codec.binary.Base64TestData.fill(byte[],int,InputStream)
org.apache.commons.codec.language.DoubleMetaphone.doubleMetaphone(String,boolean)	org.apache.commons.codec.language.DoubleMetaphone.cleanInput(String)
org.apache.commons.codec.language.DoubleMetaphone.handleCC(String,DoubleMetaphoneResult,int)	org.apache.commons.codec.language.DoubleMetaphone.DoubleMetaphoneResult.append(String)
org.apache.commons.codec.binary.Base64Test.testUrlSafe()	org.apache.commons.codec.binary.Base64TestData.randomData(int,boolean)
org.apache.commons.codec.net.QuotedPrintableCodecTest.testInvalidEncoding()	org.apache.commons.codec.net.QuotedPrintableCodec.encode(String)
org.apache.commons.codec.language.DoubleMetaphone.DoubleMetaphoneResult.append(String)	org.apache.commons.codec.language.DoubleMetaphone.DoubleMetaphoneResult.appendAlternate(String)
org.apache.commons.codec.BinaryEncoderAbstractTest.testEncodeNull()	org.apache.commons.codec.Encoder.encode(Object)
org.apache.commons.codec.binary.Base64Test.testKnownEncodings()	org.apache.commons.codec.binary.Base64.encodeBase64Chunked(byte[])
org.apache.commons.codec.language.DoubleMetaphone.handleCC(String,DoubleMetaphoneResult,int)	org.apache.commons.codec.language.DoubleMetaphone.contains(String,int,int,String,String)
org.apache.commons.codec.language.Soundex.getMappingCode(String,int)	org.apache.commons.codec.language.Soundex.map(char)
org.apache.commons.codec.digest.DigestUtils.sha512(InputStream)	org.apache.commons.codec.digest.DigestUtils.digest(MessageDigest,InputStream)
org.apache.commons.codec.language.RefinedSoundexTest.testEncode()	org.apache.commons.codec.language.RefinedSoundex.encode(String)
org.apache.commons.codec.binary.Base64OutputStream.flush(boolean)	org.apache.commons.codec.binary.Base64.avail()
org.apache.commons.codec.language.DoubleMetaphone.handleSC(String,DoubleMetaphoneResult,int)	org.apache.commons.codec.language.DoubleMetaphone.DoubleMetaphoneResult.append(char,char)
org.apache.commons.codec.binary.Base64InputStreamTest.testBase64InputStreamByChunk()	org.apache.commons.codec.binary.Base64TestData.randomData(int,boolean)
org.apache.commons.codec.language.DoubleMetaphone.contains(String,int,int,String,String)	org.apache.commons.codec.language.DoubleMetaphone.contains(String,int,int,String[])
org.apache.commons.codec.language.DoubleMetaphone.handleG(String,DoubleMetaphoneResult,int,boolean)	org.apache.commons.codec.language.DoubleMetaphone.contains(String,int,int,String[])
org.apache.commons.codec.StringEncoderAbstractTest.testEncodeWithInvalidObject()	org.apache.commons.codec.Encoder.encode(Object)
org.apache.commons.codec.net.BCodecTest.testEncodeStringWithNull()	org.apache.commons.codec.net.BCodec.encode(String,String)
org.apache.commons.codec.language.DoubleMetaphone.encode(String)	org.apache.commons.codec.language.DoubleMetaphone.doubleMetaphone(String)
org.apache.commons.codec.digest.DigestUtils.md5Hex(byte[])	org.apache.commons.codec.digest.DigestUtils.md5(byte[])
org.apache.commons.codec.language.DoubleMetaphone.handleGH(String,DoubleMetaphoneResult,int)	org.apache.commons.codec.language.DoubleMetaphone.DoubleMetaphoneResult.append(char)
org.apache.commons.codec.language.DoubleMetaphone.handleAEIOUY(String,DoubleMetaphoneResult,int)	org.apache.commons.codec.language.DoubleMetaphone.DoubleMetaphoneResult.append(char)
org.apache.commons.codec.binary.Base64Test.testIsUrlSafe()	org.apache.commons.codec.binary.Base64.isUrlSafe()
org.apache.commons.codec.binary.Base64Test.testSingletons()	org.apache.commons.codec.binary.Base64.encodeBase64(byte[])
org.apache.commons.codec.language.DoubleMetaphone.handleCC(String,DoubleMetaphoneResult,int)	org.apache.commons.codec.language.DoubleMetaphone.DoubleMetaphoneResult.append(char)
org.apache.commons.codec.net.QCodec.doDecoding(byte[])	org.apache.commons.codec.net.QuotedPrintableCodec.decodeQuotedPrintable(byte[])
org.apache.commons.codec.net.QCodec.decode(Object)	org.apache.commons.codec.net.QCodec.decode(String)
org.apache.commons.codec.digest.DigestUtilsTest.testSha384()	org.apache.commons.codec.digest.DigestUtils.sha384Hex(InputStream)
org.apache.commons.codec.language.Metaphone.isMetaphoneEqual(String,String)	org.apache.commons.codec.language.Metaphone.metaphone(String)
org.apache.commons.codec.binary.Base64Test.testObjectDecodeWithInvalidParameter()	org.apache.commons.codec.binary.Base64.decode(Object)
org.apache.commons.codec.net.QCodecTest.testUnsafeEncodeDecode()	org.apache.commons.codec.net.QCodec.decode(String)
org.apache.commons.codec.binary.Base64Test.testDiscardWhitespace()	org.apache.commons.codec.binary.Base64.discardWhitespace(byte[])
org.apache.commons.codec.net.QCodecTest.testEncodeDecodeNull()	org.apache.commons.codec.net.QCodec.decode(String)
org.apache.commons.codec.net.URLCodec.decode(Object)	org.apache.commons.codec.net.URLCodec.decode(String)
org.apache.commons.codec.digest.DigestUtilsTest.testShaHex()	org.apache.commons.codec.digest.DigestUtils.shaHex(byte[])
org.apache.commons.codec.binary.StringBytesUtils.newStringIso8859_1(byte[])	org.apache.commons.codec.binary.StringBytesUtils.newString(byte[],String)
org.apache.commons.codec.digest.DigestUtils.md5Hex(byte[])	org.apache.commons.codec.binary.Hex.encodeHex(byte[])
org.apache.commons.codec.language.RefinedSoundex.encode(String)	org.apache.commons.codec.language.RefinedSoundex.soundex(String)
org.apache.commons.codec.net.QCodecTest.testBasicEncodeDecode()	org.apache.commons.codec.net.QCodec.encode(String)
org.apache.commons.codec.language.DoubleMetaphone.conditionCH0(String,int)	org.apache.commons.codec.language.DoubleMetaphone.contains(String,int,int,String,String,String,String)
org.apache.commons.codec.binary.Base64Test.testEncodeOverMaxSize(int)	org.apache.commons.codec.binary.Base64.encodeBase64(byte[],boolean,boolean,int)
org.apache.commons.codec.language.DoubleMetaphone.handleL(String,DoubleMetaphoneResult,int)	org.apache.commons.codec.language.DoubleMetaphone.DoubleMetaphoneResult.append(char)
org.apache.commons.codec.language.DoubleMetaphone.handleT(String,DoubleMetaphoneResult,int)	org.apache.commons.codec.language.DoubleMetaphone.DoubleMetaphoneResult.append(char,char)
org.apache.commons.codec.binary.Base64.decode(byte[])	org.apache.commons.codec.binary.Base64.decodeBase64(byte[])
org.apache.commons.codec.language.DoubleMetaphone.doubleMetaphone(String,boolean)	org.apache.commons.codec.language.DoubleMetaphone.DoubleMetaphoneResult.append(char)
org.apache.commons.codec.net.URLCodecTest.testSafeCharEncodeDecode()	org.apache.commons.codec.net.URLCodec.encode(String)
org.apache.commons.codec.language.DoubleMetaphone.handleJ(String,DoubleMetaphoneResult,int,boolean)	org.apache.commons.codec.language.DoubleMetaphone.contains(String,int,int,String,String,String)
org.apache.commons.codec.digest.DigestUtils.sha256(InputStream)	org.apache.commons.codec.digest.DigestUtils.digest(MessageDigest,InputStream)
org.apache.commons.codec.digest.DigestUtils.sha(InputStream)	org.apache.commons.codec.digest.DigestUtils.getShaDigest()
org.apache.commons.codec.net.QuotedPrintableCodec.decode(String,String)	org.apache.commons.codec.net.QuotedPrintableCodec.decode(byte[])
org.apache.commons.codec.binary.Base64Test.testEmptyBase64()	org.apache.commons.codec.binary.Base64.encodeBase64(byte[])
org.apache.commons.codec.binary.StringBytesUtilsTest.testGetBytesUtf16Le()	org.apache.commons.codec.binary.StringBytesUtilsTest.testGetSupportedBytes(String)
org.apache.commons.codec.binary.Base64OutputStreamTest.testBase64OutputStreamByChunk()	org.apache.commons.codec.binary.Base64TestData.randomData(int,boolean)
org.apache.commons.codec.language.DoubleMetaphone.handleG(String,DoubleMetaphoneResult,int,boolean)	org.apache.commons.codec.language.DoubleMetaphone.DoubleMetaphoneResult.append(char)
org.apache.commons.codec.language.DoubleMetaphone.conditionL0(String,int)	org.apache.commons.codec.language.DoubleMetaphone.contains(String,int,int,String)
org.apache.commons.codec.binary.Base64Test.testCodeInteger3()	org.apache.commons.codec.binary.Base64.encodeInteger(BigInteger)
org.apache.commons.codec.binary.StringBytesUtilsTest.testGetBytesUtf16()	org.apache.commons.codec.binary.StringBytesUtilsTest.testGetSupportedBytes(String)
org.apache.commons.codec.language.DoubleMetaphone.doubleMetaphone(String,boolean)	org.apache.commons.codec.language.DoubleMetaphone.handleX(String,DoubleMetaphoneResult,int)
org.apache.commons.codec.language.DoubleMetaphone.handleGH(String,DoubleMetaphoneResult,int)	org.apache.commons.codec.language.DoubleMetaphone.contains(String,int,int,String,String)
org.apache.commons.codec.binary.StringBytesUtilsTest.testNewStringIso8859_1()	org.apache.commons.codec.binary.StringBytesUtils.newStringIso8859_1(byte[])
org.apache.commons.codec.net.URLCodecTest.testDefaultEncoding()	org.apache.commons.codec.net.URLCodecTest.validateState(URLCodec)
org.apache.commons.codec.net.BCodecTest.testInvalidEncoding()	org.apache.commons.codec.net.BCodec.decode(String)
org.apache.commons.codec.binary.Base64Test.testPairs()	org.apache.commons.codec.binary.Base64.decodeBase64(byte[])
org.apache.commons.codec.digest.DigestUtils.sha512Hex(byte[])	org.apache.commons.codec.digest.DigestUtils.sha512(byte[])
org.apache.commons.codec.language.DoubleMetaphone.handleSC(String,DoubleMetaphoneResult,int)	org.apache.commons.codec.language.DoubleMetaphone.contains(String,int,int,String,String)
org.apache.commons.codec.language.SoundexTest.testNewInstance2()	org.apache.commons.codec.language.Soundex.soundex(String)
org.apache.commons.codec.language.DoubleMetaphone.doubleMetaphone(String,boolean)	org.apache.commons.codec.language.DoubleMetaphone.handleJ(String,DoubleMetaphoneResult,int,boolean)
org.apache.commons.codec.net.URLCodecTest.testEncodeStringWithNull()	org.apache.commons.codec.net.URLCodec.encode(String,String)
org.apache.commons.codec.digest.DigestUtils.sha(String)	org.apache.commons.codec.digest.DigestUtils.sha(byte[])
org.apache.commons.codec.binary.StringBytesUtils.newStringUtf16Be(byte[])	org.apache.commons.codec.binary.StringBytesUtils.newString(byte[],String)
org.apache.commons.codec.binary.Base64InputStreamTest.testBase64InputStreamByChunk()	org.apache.commons.codec.binary.StringBytesUtils.getBytesUtf8(String)
org.apache.commons.codec.language.DoubleMetaphone.DoubleMetaphoneResult.append(char)	org.apache.commons.codec.language.DoubleMetaphone.DoubleMetaphoneResult.appendPrimary(char)
org.apache.commons.codec.net.QCodecTest.testUTF8RoundTrip()	org.apache.commons.codec.net.QCodecTest.constructString(int[])
org.apache.commons.codec.language.DoubleMetaphone.handleC(String,DoubleMetaphoneResult,int)	org.apache.commons.codec.language.DoubleMetaphone.contains(String,int,int,String,String,String)
org.apache.commons.codec.binary.Base64Test.testUUID()	org.apache.commons.codec.binary.Base64.decodeBase64(byte[])
org.apache.commons.codec.net.URLCodecTest.testEncodeNull()	org.apache.commons.codec.net.URLCodec.encode(byte[])
org.apache.commons.codec.binary.StringBytesUtils.getBytesUsAscii(String)	org.apache.commons.codec.binary.StringBytesUtils.getSupportedBytes(String,String)
org.apache.commons.codec.net.BCodec.encode(Object)	org.apache.commons.codec.net.BCodec.encode(String)
org.apache.commons.codec.binary.StringBytesUtilsTest.testNewStringBadEnc()	org.apache.commons.codec.binary.StringBytesUtils.newString(byte[],String)
org.apache.commons.codec.binary.StringBytesUtilsTest.testGetBytesUtf16Be()	org.apache.commons.codec.binary.StringBytesUtilsTest.testGetSupportedBytes(String)
org.apache.commons.codec.binary.Base64Test.testKnownEncodings()	org.apache.commons.codec.binary.Base64.encodeBase64(byte[])
org.apache.commons.codec.language.DoubleMetaphone.handleJ(String,DoubleMetaphoneResult,int,boolean)	org.apache.commons.codec.language.DoubleMetaphone.charAt(String,int)
org.apache.commons.codec.language.DoubleMetaphone.handleP(String,DoubleMetaphoneResult,int)	org.apache.commons.codec.language.DoubleMetaphone.charAt(String,int)
org.apache.commons.codec.digest.DigestUtils.sha512(String)	org.apache.commons.codec.digest.DigestUtils.sha512(byte[])
org.apache.commons.codec.binary.Base64InputStreamTest.testBase64EmptyInputStream()	org.apache.commons.codec.binary.Base64InputStreamTest.testByteByByte(byte[],byte[],int,byte[])
org.apache.commons.codec.binary.Base64Test.testEmptyBase64()	org.apache.commons.codec.binary.Base64.decodeBase64(byte[])
org.apache.commons.codec.digest.DigestUtilsTest.testSha384()	org.apache.commons.codec.digest.DigestUtils.sha384Hex(String)
org.apache.commons.codec.net.URLCodecTest.testEncodeDecodeNull()	org.apache.commons.codec.net.URLCodecTest.validateState(URLCodec)
org.apache.commons.codec.language.DoubleMetaphone.handleJ(String,DoubleMetaphoneResult,int,boolean)	org.apache.commons.codec.language.DoubleMetaphone.contains(String,int,int,String)
org.apache.commons.codec.binary.StringBytesUtils.newStringUtf16(byte[])	org.apache.commons.codec.binary.StringBytesUtils.newString(byte[],String)
org.apache.commons.codec.binary.BinaryCodecTest.testDecodebyteArray()	org.apache.commons.codec.binary.BinaryCodec.decode(byte[])
org.apache.commons.codec.language.DoubleMetaphone.handleCC(String,DoubleMetaphoneResult,int)	org.apache.commons.codec.language.DoubleMetaphone.contains(String,int,int,String,String,String)
org.apache.commons.codec.language.DoubleMetaphone.doubleMetaphone(String,boolean)	org.apache.commons.codec.language.DoubleMetaphone.handleP(String,DoubleMetaphoneResult,int)
org.apache.commons.codec.net.URLCodecTest.testUTF8RoundTrip()	org.apache.commons.codec.net.URLCodec.decode(String,String)
org.apache.commons.codec.digest.DigestUtils.sha512Hex(byte[])	org.apache.commons.codec.binary.Hex.encodeHex(byte[])
org.apache.commons.codec.language.Caverphone.encode(String)	org.apache.commons.codec.language.Caverphone.caverphone(String)
org.apache.commons.codec.net.QuotedPrintableCodec.encode(String,String)	org.apache.commons.codec.net.QuotedPrintableCodec.encode(byte[])
org.apache.commons.codec.binary.Base64Test.testTripletsChunked()	org.apache.commons.codec.binary.Base64.encodeBase64Chunked(byte[])
org.apache.commons.codec.digest.DigestUtilsTest.testMD5HexLength()	org.apache.commons.codec.digest.DigestUtils.md5Hex(byte[])
org.apache.commons.codec.binary.Base64.encodeBase64(byte[],boolean,boolean,int)	org.apache.commons.codec.binary.Base64.setInitialBuffer(byte[],int,int)
org.apache.commons.codec.net.QuotedPrintableCodecTest.testDefaultEncoding()	org.apache.commons.codec.net.QuotedPrintableCodec.encode(String,String)
org.apache.commons.codec.language.SoundexUtils.difference(StringEncoder,String,String)	org.apache.commons.codec.StringEncoder.encode(String)
org.apache.commons.codec.net.BCodec.encode(String)	org.apache.commons.codec.net.BCodec.getDefaultCharset()
org.apache.commons.codec.digest.DigestUtilsTest.testSha512()	org.apache.commons.codec.digest.DigestUtils.sha512Hex(InputStream)
org.apache.commons.codec.net.BCodec.encode(String)	org.apache.commons.codec.net.BCodec.encode(String,String)
org.apache.commons.codec.binary.StringBytesUtilsTest.testGetBytesUsAscii()	org.apache.commons.codec.binary.StringBytesUtils.getBytesUsAscii(String)
org.apache.commons.codec.language.DoubleMetaphone.handleW(String,DoubleMetaphoneResult,int)	org.apache.commons.codec.language.DoubleMetaphone.DoubleMetaphoneResult.appendAlternate(char)
org.apache.commons.codec.binary.Base64Test.testUUID()	org.apache.commons.codec.binary.Hex.encodeHex(byte[])
org.apache.commons.codec.binary.Hex.encodeHex(byte[],boolean)	org.apache.commons.codec.binary.Hex.encodeHex(byte[],char[])
org.apache.commons.codec.binary.Base64InputStreamTest.testBase64EmptyInputStream()	org.apache.commons.codec.binary.Base64InputStreamTest.testByChunk(byte[],byte[],int,byte[])
org.apache.commons.codec.language.Metaphone.encode(Object)	org.apache.commons.codec.language.Metaphone.metaphone(String)
org.apache.commons.codec.language.Soundex.soundex(String)	org.apache.commons.codec.language.Soundex.getMappingCode(String,int)
org.apache.commons.codec.net.QCodecTest.testEncodeDecodeBlanks()	org.apache.commons.codec.net.QCodec.setEncodeBlanks(boolean)
org.apache.commons.codec.language.DoubleMetaphone.handleCH(String,DoubleMetaphoneResult,int)	org.apache.commons.codec.language.DoubleMetaphone.DoubleMetaphoneResult.append(char,char)
org.apache.commons.codec.binary.Base64Test.testDecodeWithWhitespace()	org.apache.commons.codec.binary.Base64.encodeBase64(byte[])
org.apache.commons.codec.binary.Base64Test.testEncodeDecodeRandom()	org.apache.commons.codec.binary.Base64.decodeBase64(byte[])
org.apache.commons.codec.binary.BinaryCodec.toByteArray(String)	org.apache.commons.codec.binary.BinaryCodec.fromAscii(char[])
org.apache.commons.codec.digest.DigestUtilsTest.testSha512()	org.apache.commons.codec.digest.DigestUtils.sha512Hex(byte[])
org.apache.commons.codec.language.SoundexTest.testUsEnglishStatic()	org.apache.commons.codec.language.Soundex.soundex(String)
org.apache.commons.codec.net.QuotedPrintableCodecTest.testEncodeStringWithNull()	org.apache.commons.codec.net.QuotedPrintableCodec.encode(String,String)
org.apache.commons.codec.StringEncoderAbstractTest.testEncodeNull()	org.apache.commons.codec.StringEncoder.encode(String)
org.apache.commons.codec.language.DoubleMetaphone.handleW(String,DoubleMetaphoneResult,int)	org.apache.commons.codec.language.DoubleMetaphone.contains(String,int,int,String,String,String,String)
org.apache.commons.codec.language.CaverphoneTest.testSpecificationExamples()	org.apache.commons.codec.language.Caverphone.caverphone(String)
org.apache.commons.codec.net.URLCodecTest.testDecodeInvalidContent()	org.apache.commons.codec.net.URLCodecTest.validateState(URLCodec)
org.apache.commons.codec.language.DoubleMetaphone.handleP(String,DoubleMetaphoneResult,int)	org.apache.commons.codec.language.DoubleMetaphone.DoubleMetaphoneResult.append(char)
org.apache.commons.codec.language.RefinedSoundex.difference(String,String)	org.apache.commons.codec.language.SoundexUtils.difference(StringEncoder,String,String)
org.apache.commons.codec.language.SoundexTest.testNewInstance3()	org.apache.commons.codec.language.Soundex.soundex(String)
org.apache.commons.codec.net.QuotedPrintableCodec.decode(String,String)	org.apache.commons.codec.binary.StringBytesUtils.getBytesUsAscii(String)
org.apache.commons.codec.binary.HexTest.testEncodeEmpty()	org.apache.commons.codec.binary.Hex.encode(Object)
org.apache.commons.codec.binary.Hex.encode(byte[])	org.apache.commons.codec.binary.Hex.encodeHex(byte[])
org.apache.commons.codec.binary.Base64Test.testIgnoringNonBase64InDecode()	org.apache.commons.codec.binary.Base64.decodeBase64(byte[])
org.apache.commons.codec.binary.StringBytesUtilsTest.testNewStringUtf16Be()	org.apache.commons.codec.binary.StringBytesUtils.newStringUtf16Be(byte[])
org.apache.commons.codec.language.DoubleMetaphone.handleS(String,DoubleMetaphoneResult,int,boolean)	org.apache.commons.codec.language.DoubleMetaphone.DoubleMetaphoneResult.append(char)
org.apache.commons.codec.binary.Base64Test.testUUID()	org.apache.commons.codec.binary.Hex.decodeHex(char[])
org.apache.commons.codec.binary.Base64InputStream.read(byte[],int,int)	org.apache.commons.codec.binary.Base64.encode(byte[],int,int)
org.apache.commons.codec.binary.Base64InputStreamTest.testMarkSupported()	org.apache.commons.codec.binary.Base64InputStream.markSupported()
org.apache.commons.codec.binary.StringBytesUtilsTest.testGetSupportedBytesBadEnc()	org.apache.commons.codec.binary.StringBytesUtils.getSupportedBytes(String,String)
org.apache.commons.codec.net.QCodecTest.testDecodeStringWithNull()	org.apache.commons.codec.net.QCodec.decode(String)
org.apache.commons.codec.net.QCodecTest.testUnsafeEncodeDecode()	org.apache.commons.codec.net.QCodec.encode(String)
org.apache.commons.codec.net.BCodec.decode(Object)	org.apache.commons.codec.net.BCodec.decode(String)
org.apache.commons.codec.binary.Base64Test.testEncodeDecodeRandom()	org.apache.commons.codec.binary.Base64Test.getRandom()
org.apache.commons.codec.binary.Base64InputStreamTest.testByChunk(byte[],byte[],int,byte[])	org.apache.commons.codec.binary.Base64TestData.streamToBytes(InputStream)
org.apache.commons.codec.digest.DigestUtilsTest.testSha256()	org.apache.commons.codec.digest.DigestUtils.sha256Hex(InputStream)
org.apache.commons.codec.net.QCodecTest.testEncodeObjects()	org.apache.commons.codec.net.QCodec.encode(Object)
org.apache.commons.codec.binary.Base64.isArrayByteBase64(byte[])	org.apache.commons.codec.binary.Base64.isWhiteSpace(byte)
org.apache.commons.codec.digest.DigestUtils.sha512Hex(InputStream)	org.apache.commons.codec.digest.DigestUtils.sha512(InputStream)
org.apache.commons.codec.net.URLCodec.decode(Object)	org.apache.commons.codec.net.URLCodec.decode(byte[])
org.apache.commons.codec.language.DoubleMetaphone.handleCH(String,DoubleMetaphoneResult,int)	org.apache.commons.codec.language.DoubleMetaphone.conditionCH1(String,int)
org.apache.commons.codec.net.BCodec.doEncoding(byte[])	org.apache.commons.codec.binary.Base64.encodeBase64(byte[])
org.apache.commons.codec.language.Metaphone.metaphone(String)	org.apache.commons.codec.language.Metaphone.isVowel(StringBuffer,int)
org.apache.commons.codec.net.BCodec.decode(String)	org.apache.commons.codec.net.RFC1522Codec.decodeText(String)
org.apache.commons.codec.digest.DigestUtils.getSha256Digest()	org.apache.commons.codec.digest.DigestUtils.getDigest(String)
org.apache.commons.codec.language.DoubleMetaphone.handleT(String,DoubleMetaphoneResult,int)	org.apache.commons.codec.language.DoubleMetaphone.contains(String,int,int,String)
org.apache.commons.codec.binary.Base64OutputStreamTest.testBase64EmptyOutputStream()	org.apache.commons.codec.binary.Base64OutputStreamTest.testByteByByte(byte[],byte[],int,byte[])
org.apache.commons.codec.net.URLCodecTest.testEncodeUrlWithNullBitSet()	org.apache.commons.codec.net.URLCodecTest.validateState(URLCodec)
org.apache.commons.codec.net.RFC1522Codec.decodeText(String)	org.apache.commons.codec.binary.StringBytesUtils.getBytesUsAscii(String)
org.apache.commons.codec.net.URLCodec.decode(byte[])	org.apache.commons.codec.net.URLCodec.decodeUrl(byte[])
org.apache.commons.codec.binary.BinaryCodecTest.assertDecodeObject(byte[],String)	org.apache.commons.codec.binary.BinaryCodec.decode(Object)
org.apache.commons.codec.binary.Base64Test.testEncodeDecodeSmall()	org.apache.commons.codec.binary.Base64Test.toString(byte[])
org.apache.commons.codec.binary.StringBytesUtilsTest.testNewStringUtf16Le()	org.apache.commons.codec.binary.StringBytesUtilsTest.testNewString(String)
org.apache.commons.codec.language.DoubleMetaphone.handleGH(String,DoubleMetaphoneResult,int)	org.apache.commons.codec.language.DoubleMetaphone.isVowel(char)
org.apache.commons.codec.binary.Base64OutputStreamTest.testBase64OutputStreamByteByByte()	org.apache.commons.codec.binary.Base64OutputStreamTest.testByteByByte(byte[],byte[],int,byte[])
org.apache.commons.codec.digest.DigestUtils.shaHex(String)	org.apache.commons.codec.binary.Hex.encodeHex(byte[])
org.apache.commons.codec.net.BCodecTest.testUTF8RoundTrip()	org.apache.commons.codec.net.BCodec.decode(String)
org.apache.commons.codec.net.QuotedPrintableCodecTest.testDefaultEncoding()	org.apache.commons.codec.net.QuotedPrintableCodec.encode(String)
org.apache.commons.codec.net.URLCodec.encode(Object)	org.apache.commons.codec.net.URLCodec.encode(byte[])
org.apache.commons.codec.binary.Base64.encodeBase64(byte[],boolean,boolean,int)	org.apache.commons.codec.binary.Base64.encode(byte[],int,int)
org.apache.commons.codec.language.DoubleMetaphone.doubleMetaphone(String,boolean)	org.apache.commons.codec.language.DoubleMetaphone.DoubleMetaphoneResult.getPrimary()
org.apache.commons.codec.binary.Base64Test.testUUID()	org.apache.commons.codec.binary.StringBytesUtils.newStringUtf8(byte[])
org.apache.commons.codec.net.URLCodecTest.testEncodeDecodeNull()	org.apache.commons.codec.net.URLCodec.encode(String)
org.apache.commons.codec.digest.DigestUtils.sha256Hex(InputStream)	org.apache.commons.codec.binary.Hex.encodeHex(byte[])
org.apache.commons.codec.net.URLCodec.decode(String,String)	org.apache.commons.codec.binary.StringBytesUtils.getBytesUsAscii(String)
org.apache.commons.codec.digest.DigestUtils.md5(byte[])	org.apache.commons.codec.digest.DigestUtils.getMd5Digest()
org.apache.commons.codec.binary.Base64Test.testNonBase64Test()	org.apache.commons.codec.binary.Base64.isArrayByteBase64(byte[])
org.apache.commons.codec.binary.Base64Test.testCodeInteger1()	org.apache.commons.codec.binary.Base64.encodeInteger(BigInteger)
org.apache.commons.codec.binary.Base64.containsBase64Byte(byte[])	org.apache.commons.codec.binary.Base64.isBase64(byte)
org.apache.commons.codec.language.DoubleMetaphone.conditionCH1(String,int)	org.apache.commons.codec.language.DoubleMetaphone.contains(String,int,int,String,String,String)
org.apache.commons.codec.language.DoubleMetaphone.doubleMetaphone(String,boolean)	org.apache.commons.codec.language.DoubleMetaphone.handleAEIOUY(String,DoubleMetaphoneResult,int)
org.apache.commons.codec.binary.Hex.decode(byte[])	org.apache.commons.codec.binary.Hex.decodeHex(char[])
org.apache.commons.codec.net.URLCodec.decode(String)	org.apache.commons.codec.net.URLCodec.decode(String,String)
org.apache.commons.codec.net.QCodec.encode(String)	org.apache.commons.codec.net.QCodec.encode(String,String)
org.apache.commons.codec.net.URLCodec.decode(String)	org.apache.commons.codec.net.URLCodec.getDefaultCharset()
org.apache.commons.codec.binary.HexTest.testEncodeEmpty()	org.apache.commons.codec.binary.Hex.encode(byte[])
org.apache.commons.codec.digest.DigestUtils.getShaDigest()	org.apache.commons.codec.digest.DigestUtils.getDigest(String)
org.apache.commons.codec.language.DoubleMetaphone.handleS(String,DoubleMetaphoneResult,int,boolean)	org.apache.commons.codec.language.DoubleMetaphone.contains(String,int,int,String,String,String,String)
org.apache.commons.codec.language.DoubleMetaphone.handleR(String,DoubleMetaphoneResult,int,boolean)	org.apache.commons.codec.language.DoubleMetaphone.DoubleMetaphoneResult.append(char)
org.apache.commons.codec.binary.Base64InputStreamTest.testBase64InputStreamByteByByte()	org.apache.commons.codec.binary.StringBytesUtils.getBytesUtf8(String)
org.apache.commons.codec.net.URLCodecTest.testUnsafeEncodeDecode()	org.apache.commons.codec.net.URLCodecTest.validateState(URLCodec)
org.apache.commons.codec.language.DoubleMetaphone.doubleMetaphone(String)	org.apache.commons.codec.language.DoubleMetaphone.doubleMetaphone(String,boolean)
org.apache.commons.codec.binary.Base64Test.testObjectDecodeWithValidParameter()	org.apache.commons.codec.binary.Base64.encodeBase64(byte[])
org.apache.commons.codec.language.DoubleMetaphone.handleCH(String,DoubleMetaphoneResult,int)	org.apache.commons.codec.language.DoubleMetaphone.contains(String,int,int,String)
org.apache.commons.codec.net.RFC1522CodecTest.testNullInput()	org.apache.commons.codec.net.RFC1522Codec.decodeText(String)
org.apache.commons.codec.digest.DigestUtils.sha384(String)	org.apache.commons.codec.digest.DigestUtils.sha384(byte[])
org.apache.commons.codec.binary.StringBytesUtilsTest.testNewStringUtf8()	org.apache.commons.codec.binary.StringBytesUtilsTest.testNewString(String)
org.apache.commons.codec.binary.Hex.encode(Object)	org.apache.commons.codec.binary.Hex.encodeHex(byte[])
org.apache.commons.codec.language.DoubleMetaphone.handleZ(String,DoubleMetaphoneResult,int,boolean)	org.apache.commons.codec.language.DoubleMetaphone.charAt(String,int)
org.apache.commons.codec.binary.HexTest.testHelloWorldUpperCaseHex()	org.apache.commons.codec.binary.Hex.encodeHex(byte[],boolean)
org.apache.commons.codec.net.QCodec.encode(String)	org.apache.commons.codec.net.QCodec.getDefaultCharset()
org.apache.commons.codec.net.QuotedPrintableCodec.decode(Object)	org.apache.commons.codec.net.QuotedPrintableCodec.decode(byte[])
org.apache.commons.codec.binary.Base64Test.testDiscardWhitespace()	org.apache.commons.codec.binary.Base64.decodeBase64(byte[])
org.apache.commons.codec.language.DoubleMetaphone.doubleMetaphone(String,boolean)	org.apache.commons.codec.language.DoubleMetaphone.isSlavoGermanic(String)
org.apache.commons.codec.binary.StringBytesUtilsTest.testNewStringUsAscii()	org.apache.commons.codec.binary.StringBytesUtilsTest.testNewString(String)
org.apache.commons.codec.binary.StringBytesUtilsTest.testGetBytesIso8859_1()	org.apache.commons.codec.binary.StringBytesUtilsTest.testGetSupportedBytes(String)
org.apache.commons.codec.binary.Base64Test.testDecodeWithWhitespace()	org.apache.commons.codec.binary.Base64.decodeBase64(byte[])
org.apache.commons.codec.binary.HexTest.testDecodeArrayOddCharacters()	org.apache.commons.codec.binary.Hex.decode(byte[])
org.apache.commons.codec.binary.BinaryCodec.decode(byte[])	org.apache.commons.codec.binary.BinaryCodec.fromAscii(byte[])
org.apache.commons.codec.binary.BinaryCodecTest.testEncodebyteArray()	org.apache.commons.codec.binary.BinaryCodec.encode(byte[])
org.apache.commons.codec.language.DoubleMetaphone.handleT(String,DoubleMetaphoneResult,int)	org.apache.commons.codec.language.DoubleMetaphone.contains(String,int,int,String,String)
org.apache.commons.codec.binary.Base64Test.testUUID()	org.apache.commons.codec.binary.Base64.encodeBase64(byte[])
org.apache.commons.codec.language.DoubleMetaphone.handleD(String,DoubleMetaphoneResult,int)	org.apache.commons.codec.language.DoubleMetaphone.DoubleMetaphoneResult.append(char)
org.apache.commons.codec.language.DoubleMetaphone.handleH(String,DoubleMetaphoneResult,int)	org.apache.commons.codec.language.DoubleMetaphone.charAt(String,int)
org.apache.commons.codec.binary.Base64.isArrayByteBase64(byte[])	org.apache.commons.codec.binary.Base64.isBase64(byte)
org.apache.commons.codec.net.QuotedPrintableCodec.decode(String)	org.apache.commons.codec.net.QuotedPrintableCodec.decode(String,String)
org.apache.commons.codec.net.QuotedPrintableCodecTest.testInvalidEncoding()	org.apache.commons.codec.net.QuotedPrintableCodec.decode(String)
org.apache.commons.codec.binary.BinaryCodecTest.testEncodeObjectException()	org.apache.commons.codec.binary.BinaryCodec.encode(Object)
org.apache.commons.codec.language.DoubleMetaphone.handleX(String,DoubleMetaphoneResult,int)	org.apache.commons.codec.language.DoubleMetaphone.DoubleMetaphoneResult.append(String)
org.apache.commons.codec.language.DoubleMetaphone.handleL(String,DoubleMetaphoneResult,int)	org.apache.commons.codec.language.DoubleMetaphone.conditionL0(String,int)
org.apache.commons.codec.net.QuotedPrintableCodecTest.testEncodeObjects()	org.apache.commons.codec.net.QuotedPrintableCodec.encode(Object)
org.apache.commons.codec.language.DoubleMetaphone.handleGH(String,DoubleMetaphoneResult,int)	org.apache.commons.codec.language.DoubleMetaphone.contains(String,int,int,String,String,String)
org.apache.commons.codec.net.QuotedPrintableCodec.encode(Object)	org.apache.commons.codec.net.QuotedPrintableCodec.encode(byte[])
org.apache.commons.codec.net.URLCodec.decode(String,String)	org.apache.commons.codec.net.URLCodec.decode(byte[])
org.apache.commons.codec.binary.BinaryCodecTest.testFromAsciibyteArray()	org.apache.commons.codec.binary.BinaryCodec.fromAscii(byte[])
org.apache.commons.codec.net.URLCodecTest.testUnsafeEncodeDecode()	org.apache.commons.codec.net.URLCodec.encode(String)
org.apache.commons.codec.language.RefinedSoundex.soundex(String)	org.apache.commons.codec.language.RefinedSoundex.getMappingCode(char)
org.apache.commons.codec.binary.StringBytesUtilsTest.testNewStringUtf16Be()	org.apache.commons.codec.binary.StringBytesUtilsTest.testNewString(String)
org.apache.commons.codec.digest.DigestUtilsTest.testMd5Hex()	org.apache.commons.codec.digest.DigestUtils.md5Hex(InputStream)
org.apache.commons.codec.net.QuotedPrintableCodec.encode(byte[])	org.apache.commons.codec.net.QuotedPrintableCodec.encodeQuotedPrintable(BitSet,byte[])
