Caller	Callee
org.apache.commons.codec.language.bm.Lang.guessLanguage(String)	org.apache.commons.codec.language.bm.Languages.LanguageSet.isSingleton()
org.apache.commons.codec.language.DoubleMetaphone.handleC(String,DoubleMetaphoneResult,int)	org.apache.commons.codec.language.DoubleMetaphone.DoubleMetaphoneResult.append(char,char)
org.apache.commons.codec.binary.BaseNCodecTest.testIsInAlphabetByte()	org.apache.commons.codec.binary.BaseNCodec.isInAlphabet(byte)
org.apache.commons.codec.binary.BinaryCodec.toAsciiString(byte[])	org.apache.commons.codec.binary.BinaryCodec.toAsciiChars(byte[])
org.apache.commons.codec.binary.Base64TestData.randomData(int,boolean)	org.apache.commons.codec.binary.Base64.encodeBase64(byte[])
org.apache.commons.codec.language.Caverphone1Test.testIsCaverphoneEquals()	org.apache.commons.codec.language.AbstractCaverphone.isEncodeEqual(String,String)
org.apache.commons.codec.language.Caverphone2Test.testCaverphoneRevisitedRandomNameTTA1111111()	org.apache.commons.codec.StringEncoderAbstractTest.checkEncodingVariations(String,String[])
org.apache.commons.codec.language.MetaphoneTest.testWordsWithCIA()	org.apache.commons.codec.language.MetaphoneTest.getMetaphone()
org.apache.commons.codec.language.bm.BeiderMorseEncoderTest.createGenericApproxEncoder()	org.apache.commons.codec.language.bm.BeiderMorseEncoder.setNameType(NameType)
org.apache.commons.codec.language.DoubleMetaphoneTest.testIsDoubleMetaphoneEqualWithMATCHES()	org.apache.commons.codec.language.DoubleMetaphoneTest.getDoubleMetaphone()
org.apache.commons.codec.net.BCodecTest.testBasicEncodeDecode()	org.apache.commons.codec.net.BCodec.decode(String)
org.apache.commons.codec.net.QuotedPrintableBinaryCodecTest.testEncodeObjects()	org.apache.commons.codec.net.QuotedPrintableCodec.encode(byte[])
org.apache.commons.codec.binary.StringUtils.newString(byte[],String)	org.apache.commons.codec.binary.StringUtils.newIllegalStateException(String,UnsupportedEncodingException)
org.apache.commons.codec.language.DoubleMetaphone.handleW(String,DoubleMetaphoneResult,int)	org.apache.commons.codec.language.DoubleMetaphone.charAt(String,int)
org.apache.commons.codec.net.QuotedPrintableStringCodec.encode(String)	org.apache.commons.codec.net.QuotedPrintableCodec.getDefaultCharset()
org.apache.commons.codec.binary.HexCharTest.testDecodeArrayOddCharacters()	org.apache.commons.codec.binary.Hex.decode(byte[])
org.apache.commons.codec.binary.Base64.encodeInteger(BigInteger)	org.apache.commons.codec.binary.Base64.encodeBase64(byte[],boolean)
org.apache.commons.codec.binary.BinaryCharCodecTest.testFromAsciiCharArray()	org.apache.commons.codec.binary.BinaryCodec.fromAscii(char[])
org.apache.commons.codec.binary.Base32OutputStreamTest.testBase32EmptyOutputStreamPemChunkSize()	org.apache.commons.codec.binary.Base32OutputStreamTest.testBase32EmptyOutputStream(int)
org.apache.commons.codec.language.AbstractCaverphone.isEncodeEqual(String,String)	org.apache.commons.codec.StringEncoder.encode(String)
org.apache.commons.codec.binary.BinaryCodec.fromAscii(byte[])	org.apache.commons.codec.binary.BinaryCodec.isEmpty(byte[])
org.apache.commons.codec.language.Caverphone1Test.testSpecificationV1Examples()	org.apache.commons.codec.StringEncoderAbstractTest.checkEncodings(String[][])
org.apache.commons.codec.digest.DigestUtils.sha384Hex(byte[])	org.apache.commons.codec.digest.DigestUtils.sha384(byte[])
org.apache.commons.codec.language.DoubleMetaphone.handleS(String,DoubleMetaphoneResult,int,boolean)	org.apache.commons.codec.language.DoubleMetaphone.DoubleMetaphoneResult.appendAlternate(char)
org.apache.commons.codec.language.DoubleMetaphone.conditionC0(String,int)	org.apache.commons.codec.language.DoubleMetaphone.charAt(String,int)
org.apache.commons.codec.net.URLCodecStringTest.testDecodeStringWithNull()	org.apache.commons.codec.net.URLStringCodec.decode(String,String)
org.apache.commons.codec.language.DoubleMetaphone.handleX(String,DoubleMetaphoneResult,int)	org.apache.commons.codec.language.DoubleMetaphone.DoubleMetaphoneResult.append(char)
org.apache.commons.codec.binary.Base64Test.testChunkedEncodeMultipleOf76()	org.apache.commons.codec.binary.Base64.encodeBase64(byte[],boolean)
org.apache.commons.codec.net.RFC1522Codec.decodeText(String)	org.apache.commons.codec.binary.StringUtils.getBytesUsAscii(String)
org.apache.commons.codec.binary.Base64InputStreamTest.testBase64EmptyInputStream(int)	org.apache.commons.codec.binary.Base64InputStreamTest.testByChunk(byte[],byte[],int,byte[])
org.apache.commons.codec.binary.BaseNCodec.decode(byte[])	org.apache.commons.codec.binary.BaseNCodec.reset()
org.apache.commons.codec.language.bm.PhoneticEngine.encode(String,LanguageSet)	org.apache.commons.codec.language.bm.Rule.getInstance(NameType,RuleType,LanguageSet)
org.apache.commons.codec.binary.Base64Test.testEncodeDecode(String)	org.apache.commons.codec.binary.Base64.decodeBase64(String)
org.apache.commons.codec.binary.Base64Test.testSingletonsChunked()	org.apache.commons.codec.binary.Base64.encodeBase64Chunked(byte[])
org.apache.commons.codec.binary.Base64Test.testByteToStringVariations()	org.apache.commons.codec.binary.Base64.encodeBase64URLSafeString(byte[])
org.apache.commons.codec.language.DoubleMetaphone.handleW(String,DoubleMetaphoneResult,int)	org.apache.commons.codec.language.DoubleMetaphone.isVowel(char)
org.apache.commons.codec.binary.Base64Test.testDecodePadOnlyChunked()	org.apache.commons.codec.binary.Base64.decodeBase64(byte[])
org.apache.commons.codec.binary.Base32Test.testRandomBytesChunked()	org.apache.commons.codec.binary.BaseNCodec.getEncodedLength(byte[])
org.apache.commons.codec.binary.BinaryCharCodecTest.testDecodeByteArray()	org.apache.commons.codec.binary.BinaryCodec.decode(byte[])
org.apache.commons.codec.binary.HexByteTest.testCustomCharset(String,String)	org.apache.commons.codec.binary.HexByteTest.log(String)
org.apache.commons.codec.binary.Base64Test.testEncodeDecodeRandom()	org.apache.commons.codec.binary.Base64.encodeBase64(byte[])
org.apache.commons.codec.binary.Base64Test.testCodeInteger3()	org.apache.commons.codec.binary.Base64.decodeInteger(byte[])
org.apache.commons.codec.digest.DigestUtils.sha512Hex(InputStream)	org.apache.commons.codec.binary.Hex.encodeHexString(byte[])
org.apache.commons.codec.binary.HexByteTest.testDecodeBadCharacterPos1()	org.apache.commons.codec.binary.Hex.decode(String)
org.apache.commons.codec.net.URLCodecStringTest.testDecodeWithNullArray()	org.apache.commons.codec.net.URLCodec.decodeUrl(byte[])
org.apache.commons.codec.binary.Base32OutputStreamTest.testBase32OutputStreamByChunk()	org.apache.commons.codec.binary.StringUtils.getBytesUtf8(String)
org.apache.commons.codec.digest.DigestUtils.shaHex(InputStream)	org.apache.commons.codec.binary.Hex.encodeHexString(byte[])
org.apache.commons.codec.binary.Base64Test.testDecodePadOnly()	org.apache.commons.codec.binary.Base64.decodeBase64(byte[])
org.apache.commons.codec.language.bm.RuleTest.testSubSequenceWorks()	org.apache.commons.codec.language.bm.Rule.Phoneme.getPhonemeText()
org.apache.commons.codec.language.DoubleMetaphoneTest.testNTilde()	org.apache.commons.codec.language.DoubleMetaphoneTest.getDoubleMetaphone()
org.apache.commons.codec.language.bm.PhoneticEngine.applyFinalRules(PhonemeBuilder,List<Rule>)	org.apache.commons.codec.language.bm.Rule.Phoneme.getPhonemeText()
org.apache.commons.codec.language.bm.BeiderMorseEncoderTest.testAsciiEncodeNotEmpty1Letter()	org.apache.commons.codec.language.bm.BeiderMorseEncoderTest.createGenericApproxEncoder()
org.apache.commons.codec.language.DoubleMetaphone.handleX(String,DoubleMetaphoneResult,int)	org.apache.commons.codec.language.DoubleMetaphone.contains(String,int,int,String,String)
org.apache.commons.codec.language.MetaphoneTest.testIsMetaphoneEqual1()	org.apache.commons.codec.language.MetaphoneTest.assertMetaphoneEqual(String[][])
org.apache.commons.codec.binary.BaseNCodec.decode(String)	org.apache.commons.codec.binary.StringUtils.getBytesUtf8(String)
org.apache.commons.codec.language.Metaphone.metaphone(String)	org.apache.commons.codec.language.Metaphone.getMaxCodeLen()
org.apache.commons.codec.language.SoundexTest.testEncodeBatch4()	org.apache.commons.codec.language.Soundex.encode(String)
org.apache.commons.codec.net.BCodecTest.testBasicEncodeDecode()	org.apache.commons.codec.net.BCodec.encode(String)
org.apache.commons.codec.binary.Base32.decode(byte[],int,int)	org.apache.commons.codec.binary.BaseNCodec.ensureBufferSize(int)
org.apache.commons.codec.language.DoubleMetaphone.conditionCH1(String,int)	org.apache.commons.codec.language.DoubleMetaphone.contains(String,int,int,String)
org.apache.commons.codec.language.Caverphone2Test.testCaverphoneRevisitedRandomNameTN11111111()	org.apache.commons.codec.StringEncoderAbstractTest.checkEncodingVariations(String,String[])
org.apache.commons.codec.binary.Base64Test.testEncodeDecodeSmall()	org.apache.commons.codec.binary.Base64Test.getRandom()
org.apache.commons.codec.language.DoubleMetaphoneTest.assertDoubleMetaphone(String,String)	org.apache.commons.codec.language.DoubleMetaphone.doubleMetaphone(String)
org.apache.commons.codec.net.URLCodecBinaryTest.testDecodeObjects()	org.apache.commons.codec.net.URLCodec.decode(byte[])
org.apache.commons.codec.language.Soundex.difference(String,String)	org.apache.commons.codec.language.SoundexUtils.difference(StringEncoder,String,String)
org.apache.commons.codec.digest.DigestUtils.md5(String)	org.apache.commons.codec.digest.DigestUtils.getBytesUtf8(String)
org.apache.commons.codec.language.bm.Rule.getInstance(NameType,RuleType,LanguageSet)	org.apache.commons.codec.language.bm.Languages.LanguageSet.getAny()
org.apache.commons.codec.binary.HexCharTest.testCustomCharset(String,String)	org.apache.commons.codec.binary.Hex.encode(String)
org.apache.commons.codec.language.DoubleMetaphoneTest.doubleMetaphoneNotEqualTest(boolean)	org.apache.commons.codec.language.DoubleMetaphoneTest.getDoubleMetaphone()
org.apache.commons.codec.binary.Base64Test.testEncodeDecode(String)	org.apache.commons.codec.binary.StringUtils.getBytesUtf8(String)
org.apache.commons.codec.language.bm.Languages.SomeLanguages.restrictTo(LanguageSet)	org.apache.commons.codec.language.bm.Languages.LanguageSet.from(Set<String>)
org.apache.commons.codec.binary.HexByteTest.testHelloWorldLowerCaseHex()	org.apache.commons.codec.binary.StringUtils.getBytesUtf8(String)
org.apache.commons.codec.net.URLCodecBinaryTest.testEncodeObjects()	org.apache.commons.codec.net.URLCodec.encode(byte[])
org.apache.commons.codec.binary.Base64InputStreamTest.testRead0()	org.apache.commons.codec.binary.StringUtils.getBytesUtf8(String)
org.apache.commons.codec.language.DoubleMetaphoneTest.testIsDoubleMetaphoneEqualExtended3()	org.apache.commons.codec.language.DoubleMetaphoneTest.getDoubleMetaphone()
org.apache.commons.codec.language.DoubleMetaphone.doubleMetaphone(String,boolean)	org.apache.commons.codec.language.DoubleMetaphone.getMaxCodeLen()
org.apache.commons.codec.binary.HexByteTest.testCustomCharset(String,String)	org.apache.commons.codec.binary.HexByteTest.charsetSanityCheck(String)
org.apache.commons.codec.language.MetaphoneTest.testWordsWithCIA()	org.apache.commons.codec.language.Metaphone.metaphone(String)
org.apache.commons.codec.language.DoubleMetaphone.doubleMetaphone(String,boolean)	org.apache.commons.codec.language.DoubleMetaphone.handleH(String,DoubleMetaphoneResult,int)
org.apache.commons.codec.language.DoubleMetaphone.handleCH(String,DoubleMetaphoneResult,int)	org.apache.commons.codec.language.DoubleMetaphone.conditionCH0(String,int)
org.apache.commons.codec.binary.HexByteTest.testCustomCharset(String,String)	org.apache.commons.codec.binary.Hex.decode(String)
org.apache.commons.codec.binary.BinaryByteCodecTest.assertDecodeObject(byte[],String)	org.apache.commons.codec.binary.BinaryCodec.decode(char[])
org.apache.commons.codec.net.QuotedPrintableBinaryCodecTest.testDecodeObjects()	org.apache.commons.codec.net.QuotedPrintableCodec.decode(byte[])
org.apache.commons.codec.binary.HexCharTest.testEncodeDecodeRandom()	org.apache.commons.codec.binary.Hex.decode(String)
org.apache.commons.codec.net.QuotedPrintableStringCodecTest.testEncodeDecodeNull()	org.apache.commons.codec.net.QuotedPrintableStringCodec.decode(String)
org.apache.commons.codec.language.Soundex.map(char)	org.apache.commons.codec.language.Soundex.getSoundexMapping()
org.apache.commons.codec.language.DoubleMetaphone.conditionCH0(String,int)	org.apache.commons.codec.language.DoubleMetaphone.contains(String,int,int,String)
org.apache.commons.codec.language.bm.Rule.parseRules(Scanner,String)	org.apache.commons.codec.language.bm.Rule.parseRules(Scanner,String)
org.apache.commons.codec.binary.Base64InputStreamTest.testCodec98NPE()	org.apache.commons.codec.binary.StringUtils.getBytesUtf8(String)
org.apache.commons.codec.language.DoubleMetaphone.DoubleMetaphoneResult.append(String,String)	org.apache.commons.codec.language.DoubleMetaphone.DoubleMetaphoneResult.appendPrimary(String)
org.apache.commons.codec.language.MetaphoneTest.testDiscardOfSCEOrSCIOrSCY()	org.apache.commons.codec.language.MetaphoneTest.getMetaphone()
org.apache.commons.codec.binary.Base32OutputStreamTest.testBase32OutputStreamByChunk()	org.apache.commons.codec.binary.Base32TestData.randomData(BaseNCodec,int)
org.apache.commons.codec.binary.HexCharTest.testDecodeStringOddCharacters()	org.apache.commons.codec.binary.Hex.decode(String)
org.apache.commons.codec.digest.DigestUtils.sha256Hex(String)	org.apache.commons.codec.digest.DigestUtils.sha256(String)
org.apache.commons.codec.language.DoubleMetaphone.conditionL0(String,int)	org.apache.commons.codec.language.DoubleMetaphone.contains(String,int,int,String,String)
org.apache.commons.codec.binary.Base64InputStreamTest.testReadNull()	org.apache.commons.codec.binary.BaseNCodecInputStream.read(byte[],int,int)
org.apache.commons.codec.binary.Base64Test.testCodec112()	org.apache.commons.codec.binary.Base64.encodeBase64(byte[])
org.apache.commons.codec.binary.Base64OutputStreamTest.testCodec98NPE()	org.apache.commons.codec.binary.StringUtils.newStringUtf8(byte[])
org.apache.commons.codec.language.bm.BeiderMorseEncoderTest.testSpeedCheck3()	org.apache.commons.codec.language.bm.BeiderMorseEncoderTest.createGenericApproxEncoder()
org.apache.commons.codec.digest.DigestUtilsTest.testSha512()	org.apache.commons.codec.digest.DigestUtilsTest.getBytesUtf8(String)
org.apache.commons.codec.language.MetaphoneTest.testIsMetaphoneEqualAlbert()	org.apache.commons.codec.language.MetaphoneTest.assertIsMetaphoneEqual(String,String[])
org.apache.commons.codec.language.MetaphoneTest.assertMetaphoneEqual(String[][])	org.apache.commons.codec.language.MetaphoneTest.validateFixture(String[][])
org.apache.commons.codec.digest.DigestUtils.shaHex(String)	org.apache.commons.codec.binary.Hex.encodeHexString(byte[])
org.apache.commons.codec.binary.HexByteTest.testEncodeDecodeRandom()	org.apache.commons.codec.binary.Hex.decode(String)
org.apache.commons.codec.language.ColognePhonetic.CologneInputBuffer.getNextChar()	org.apache.commons.codec.language.ColognePhonetic.CologneInputBuffer.getNextPos()
org.apache.commons.codec.binary.Base64Test.testEncodeDecode(String)	org.apache.commons.codec.binary.StringUtils.newStringUsAscii(byte[])
org.apache.commons.codec.language.bm.BeiderMorseEncoder.setRuleType(RuleType)	org.apache.commons.codec.language.bm.PhoneticEngine.getNameType()
org.apache.commons.codec.language.bm.PhoneticEngine.PhonemeBuilder.makeString()	org.apache.commons.codec.language.bm.Rule.Phoneme.getPhonemeText()
org.apache.commons.codec.net.RFC1522CodecTest.testNullInput()	org.apache.commons.codec.net.RFC1522Codec.encodeText(String,String)
org.apache.commons.codec.digest.DigestUtilsTest.testMd5Hex()	org.apache.commons.codec.digest.DigestUtils.md5Hex(String)
org.apache.commons.codec.language.bm.BeiderMorseEncoder.getNameType()	org.apache.commons.codec.language.bm.PhoneticEngine.getNameType()
org.apache.commons.codec.net.RFC1522Codec.encodeText(String,String)	org.apache.commons.codec.binary.StringUtils.newStringUsAscii(byte[])
org.apache.commons.codec.net.QuotedPrintableStringCodec.decode(String)	org.apache.commons.codec.net.QuotedPrintableStringCodec.decode(String,String)
org.apache.commons.codec.language.ColognePhonetic.colognePhonetic(String)	org.apache.commons.codec.language.ColognePhonetic.preprocess(String)
org.apache.commons.codec.net.QCodecTest.testInvalidEncoding()	org.apache.commons.codec.net.QCodec.encode(String)
org.apache.commons.codec.binary.StringUtils.getBytesUtf8(String)	org.apache.commons.codec.binary.StringUtils.getBytesUnchecked(String,String)
org.apache.commons.codec.language.bm.Rule.isMatch(CharSequence)	org.apache.commons.codec.language.bm.Rule.startsWith(CharSequence,CharSequence)
org.apache.commons.codec.language.DoubleMetaphone.conditionC0(String,int)	org.apache.commons.codec.language.DoubleMetaphone.isVowel(char)
org.apache.commons.codec.language.bm.Rule.getInstance(NameType,RuleType,LanguageSet)	org.apache.commons.codec.language.bm.Languages.LanguageSet.isSingleton()
org.apache.commons.codec.binary.Base32Test.testBase32Samples()	org.apache.commons.codec.binary.BaseNCodec.encodeAsString(byte[])
org.apache.commons.codec.binary.Base64Test.testDecodeEncode(String)	org.apache.commons.codec.binary.StringUtils.getBytesUtf8(String)
org.apache.commons.codec.digest.DigestUtils.shaHex(String)	org.apache.commons.codec.digest.DigestUtils.sha(String)
org.apache.commons.codec.binary.Base64.isBase64(byte[])	org.apache.commons.codec.binary.BaseNCodec.isWhiteSpace(byte)
org.apache.commons.codec.binary.BinaryCharCodecTest.testToAsciiBytes()	org.apache.commons.codec.binary.BinaryCodec.toAsciiBytes(byte[])
org.apache.commons.codec.binary.StringUtilsTest.testGetBytesUsAscii()	org.apache.commons.codec.binary.StringUtilsTest.testGetBytesUnchecked(String)
org.apache.commons.codec.binary.Base64OutputStreamTest.testBase64EmptyOutputStreamMimeChunkSize()	org.apache.commons.codec.binary.Base64OutputStreamTest.testBase64EmptyOutputStream(int)
org.apache.commons.codec.binary.Base64Test.testDecodeEncode(String)	org.apache.commons.codec.binary.Base64.decodeBase64(String)
org.apache.commons.codec.StringEncoderAbstractTest.checkEncodingVariations(String,String[])	org.apache.commons.codec.StringEncoderAbstractTest.checkEncoding(String,String)
org.apache.commons.codec.digest.DigestUtils.shaHex(InputStream)	org.apache.commons.codec.digest.DigestUtils.sha(InputStream)
org.apache.commons.codec.net.QCodecTest.testLetUsMakeCloverHappy()	org.apache.commons.codec.net.QCodec.isEncodeBlanks()
org.apache.commons.codec.language.bm.BeiderMorseEncoderTest.testSpeedCheck3()	org.apache.commons.codec.language.bm.BeiderMorseEncoder.encode(String)
org.apache.commons.codec.language.MetaphoneTest.getMetaphone()	org.apache.commons.codec.StringEncoderAbstractTest.getStringEncoder()
org.apache.commons.codec.binary.StringUtilsTest.testNewStringUtf8()	org.apache.commons.codec.binary.StringUtils.newStringUtf8(byte[])
org.apache.commons.codec.binary.HexByteTest.testEncodeZeroes()	org.apache.commons.codec.binary.Hex.encodeHex(byte[])
org.apache.commons.codec.net.URLCodecStringTest.testDecodeInvalidContent()	org.apache.commons.codec.net.URLCodecStringTest.validateState(URLStringCodec)
org.apache.commons.codec.language.Caverphone1Test.testWikipediaExamples()	org.apache.commons.codec.StringEncoderAbstractTest.checkEncodings(String[][])
org.apache.commons.codec.binary.BaseNCodecInputStream.read()	org.apache.commons.codec.binary.BaseNCodecInputStream.read(byte[],int,int)
org.apache.commons.codec.language.bm.Rule.parseRules(Scanner,String)	org.apache.commons.codec.language.bm.Rule.createScanner(String)
org.apache.commons.codec.language.MetaphoneTest.assertIsMetaphoneEqual(String,String[])	org.apache.commons.codec.language.MetaphoneTest.getMetaphone()
org.apache.commons.codec.binary.Base32Test.testBase32Chunked()	org.apache.commons.codec.binary.BaseNCodec.encodeAsString(byte[])
org.apache.commons.codec.language.bm.PhoneticEngine.PhonemeBuilder.append(CharSequence)	org.apache.commons.codec.language.bm.Rule.Phoneme.append(CharSequence)
org.apache.commons.codec.binary.BinaryByteCodec.encode(byte[])	org.apache.commons.codec.binary.BinaryCodec.toAsciiBytes(byte[])
org.apache.commons.codec.language.DoubleMetaphone.handleSC(String,DoubleMetaphoneResult,int)	org.apache.commons.codec.language.DoubleMetaphone.DoubleMetaphoneResult.append(String,String)
org.apache.commons.codec.language.DoubleMetaphone.doubleMetaphone(String,boolean)	org.apache.commons.codec.language.DoubleMetaphone.handleZ(String,DoubleMetaphoneResult,int,boolean)
org.apache.commons.codec.net.QuotedPrintableStringCodecTest.testEncodeUrlWithNullBitSet()	org.apache.commons.codec.net.QuotedPrintableCodec.encodeQuotedPrintable(BitSet,byte[])
org.apache.commons.codec.language.DoubleMetaphone2Test.checkDoubleMetaphone(int,boolean)	org.apache.commons.codec.language.DoubleMetaphone2Test.getDoubleMetaphone()
org.apache.commons.codec.language.SoundexTest.getSoundexEncoder()	org.apache.commons.codec.StringEncoderAbstractTest.getStringEncoder()
org.apache.commons.codec.language.MetaphoneTest.testSetMaxLengthWithTruncation()	org.apache.commons.codec.language.Metaphone.setMaxCodeLen(int)
org.apache.commons.codec.binary.Hex.encodeHex(byte[])	org.apache.commons.codec.binary.Hex.encodeHex(byte[],boolean)
org.apache.commons.codec.digest.DigestUtilsTest.testMD5Length()	org.apache.commons.codec.digest.DigestUtils.md5(byte[])
org.apache.commons.codec.language.MetaphoneTest.testDiscardOfSCEOrSCIOrSCY()	org.apache.commons.codec.language.Metaphone.metaphone(String)
org.apache.commons.codec.digest.DigestUtilsTest.testShaHex()	org.apache.commons.codec.digest.DigestUtilsTest.getBytesUtf8(String)
org.apache.commons.codec.binary.Base64Test.testCodeInteger1()	org.apache.commons.codec.binary.Base64.decodeInteger(byte[])
org.apache.commons.codec.language.Caverphone2Test.testCaverphoneRevisitedCommonCodeAT11111111()	org.apache.commons.codec.StringEncoderAbstractTest.checkEncodingVariations(String,String[])
org.apache.commons.codec.binary.Base64Test.testBase64()	org.apache.commons.codec.binary.StringUtils.newStringUtf8(byte[])
org.apache.commons.codec.binary.StringUtilsTest.testNewStringUtf16Be()	org.apache.commons.codec.binary.StringUtilsTest.testNewString(String)
org.apache.commons.codec.language.DoubleMetaphoneTest.testIsDoubleMetaphoneEqualExtended3()	org.apache.commons.codec.language.DoubleMetaphone.isDoubleMetaphoneEqual(String,String,boolean)
org.apache.commons.codec.binary.HexByteTest.testEncodeDecodeRandom()	org.apache.commons.codec.binary.Hex.decodeHex(char[])
org.apache.commons.codec.binary.StringUtils.getBytesUtf16Be(String)	org.apache.commons.codec.binary.StringUtils.getBytesUnchecked(String,String)
org.apache.commons.codec.net.QCodec.decode(String)	org.apache.commons.codec.net.RFC1522Codec.decodeText(String)
org.apache.commons.codec.language.DoubleMetaphone.handleS(String,DoubleMetaphoneResult,int,boolean)	org.apache.commons.codec.language.DoubleMetaphone.contains(String,int,int,String)
org.apache.commons.codec.binary.Base64Test.testRfc4648Section10Encode()	org.apache.commons.codec.binary.StringUtils.getBytesUtf8(String)
org.apache.commons.codec.language.DoubleMetaphone.handleS(String,DoubleMetaphoneResult,int,boolean)	org.apache.commons.codec.language.DoubleMetaphone.contains(String,int,int,String,String)
org.apache.commons.codec.binary.Base64Test.testNonBase64Test()	org.apache.commons.codec.binary.BaseNCodec.decode(byte[])
org.apache.commons.codec.language.MetaphoneTest.testSetMaxLengthWithTruncation()	org.apache.commons.codec.language.Metaphone.metaphone(String)
org.apache.commons.codec.binary.HexCharTest.testRequiredCharset()	org.apache.commons.codec.binary.HexCharTest.testCustomCharset(String,String)
org.apache.commons.codec.binary.Base64Test.testUrlSafe()	org.apache.commons.codec.binary.Base64TestData.bytesContain(byte[],byte)
org.apache.commons.codec.net.URLCodecBinaryTest.testEncodeObjects()	org.apache.commons.codec.net.URLCodecBinaryTest.validateState(URLBinaryCodec)
org.apache.commons.codec.binary.Base64Test.testRfc4648Section10Encode()	org.apache.commons.codec.binary.Base64.encodeBase64String(byte[])
org.apache.commons.codec.language.DoubleMetaphoneTest.doubleMetaphoneEqualTest(String[][],boolean)	org.apache.commons.codec.language.DoubleMetaphoneTest.validateFixture(String[][])
org.apache.commons.codec.net.BCodec.encode(String,String)	org.apache.commons.codec.net.RFC1522Codec.encodeText(String,String)
org.apache.commons.codec.binary.Base64Test.testKnownDecodings()	org.apache.commons.codec.binary.Base64.decodeBase64(byte[])
org.apache.commons.codec.binary.Base64Test.testConstructor_Int_ByteArray_Boolean()	org.apache.commons.codec.binary.BaseNCodec.encode(byte[])
org.apache.commons.codec.binary.Base32Test.testRandomBytesHex()	org.apache.commons.codec.binary.Base32TestData.randomData(BaseNCodec,int)
org.apache.commons.codec.language.DoubleMetaphoneTest.testCCedilla()	org.apache.commons.codec.language.DoubleMetaphone.isDoubleMetaphoneEqual(String,String)
org.apache.commons.codec.language.Metaphone.metaphone(String)	org.apache.commons.codec.language.Metaphone.isLastChar(int,int)
org.apache.commons.codec.digest.DigestUtils.shaHex(byte[])	org.apache.commons.codec.digest.DigestUtils.sha(byte[])
org.apache.commons.codec.binary.HexCharTest.testCustomCharset()	org.apache.commons.codec.binary.HexCharTest.testCustomCharset(String,String)
org.apache.commons.codec.digest.DigestUtils.sha384(InputStream)	org.apache.commons.codec.digest.DigestUtils.digest(MessageDigest,InputStream)
org.apache.commons.codec.language.RefinedSoundex.soundex(String)	org.apache.commons.codec.language.SoundexUtils.clean(String)
org.apache.commons.codec.language.bm.LanguageGuessingTest.testLanguageGuessing()	org.apache.commons.codec.language.bm.Languages.LanguageSet.contains(String)
org.apache.commons.codec.language.SoundexTest.testUsMappingEWithAcute()	org.apache.commons.codec.language.Soundex.encode(String)
org.apache.commons.codec.net.QuotedPrintableStringCodecTest.testDefaultEncoding()	org.apache.commons.codec.net.QuotedPrintableStringCodec.encode(String)
org.apache.commons.codec.net.QuotedPrintableStringCodecTest.testBasicEncodeDecode()	org.apache.commons.codec.net.QuotedPrintableStringCodec.encode(String)
org.apache.commons.codec.language.bm.Rule.parseRules(Scanner,String)	org.apache.commons.codec.language.bm.Rule.stripQuotes(String)
org.apache.commons.codec.language.SoundexTest.testDifference()	org.apache.commons.codec.language.Soundex.difference(String,String)
org.apache.commons.codec.language.DoubleMetaphone2Test.testDoubleMetaphoneAlternate()	org.apache.commons.codec.language.DoubleMetaphone2Test.checkDoubleMetaphone(int,boolean)
org.apache.commons.codec.net.QCodec.encode(String,String)	org.apache.commons.codec.net.RFC1522Codec.encodeText(String,String)
org.apache.commons.codec.binary.HexCharTest.testCustomCharsetToString()	org.apache.commons.codec.binary.Hex.toString()
org.apache.commons.codec.language.DoubleMetaphone.isDoubleMetaphoneEqual(String,String)	org.apache.commons.codec.language.DoubleMetaphone.isDoubleMetaphoneEqual(String,String,boolean)
org.apache.commons.codec.digest.DigestUtils.md5Hex(byte[])	org.apache.commons.codec.binary.Hex.encodeHexString(byte[])
org.apache.commons.codec.language.DoubleMetaphone.handleC(String,DoubleMetaphoneResult,int)	org.apache.commons.codec.language.DoubleMetaphone.contains(String,int,int,String,String)
org.apache.commons.codec.binary.Base64Codec13Test.testEncoder()	org.apache.commons.codec.Encoder.encode(I)
org.apache.commons.codec.language.RefinedSoundexTest.testNewInstance()	org.apache.commons.codec.language.RefinedSoundex.soundex(String)
org.apache.commons.codec.binary.BaseNCodecInputStream.read(byte[],int,int)	org.apache.commons.codec.binary.BaseNCodec.hasData()
org.apache.commons.codec.digest.DigestUtils.md5(InputStream)	org.apache.commons.codec.digest.DigestUtils.digest(MessageDigest,InputStream)
org.apache.commons.codec.language.MetaphoneTest.testIsMetaphoneEqualMary()	org.apache.commons.codec.language.MetaphoneTest.assertIsMetaphoneEqual(String,String[])
org.apache.commons.codec.binary.Base32InputStreamTest.testReadNull()	org.apache.commons.codec.binary.StringUtils.getBytesUtf8(String)
org.apache.commons.codec.language.DoubleMetaphone.handleP(String,DoubleMetaphoneResult,int)	org.apache.commons.codec.language.DoubleMetaphone.contains(String,int,int,String,String)
org.apache.commons.codec.binary.HexByteTest.testHelloWorldUpperCaseHex()	org.apache.commons.codec.binary.Hex.encodeHex(byte[])
org.apache.commons.codec.language.DoubleMetaphone.handleG(String,DoubleMetaphoneResult,int,boolean)	org.apache.commons.codec.language.DoubleMetaphone.handleGH(String,DoubleMetaphoneResult,int)
org.apache.commons.codec.binary.Base64.encodeBase64(byte[],boolean,boolean,int)	org.apache.commons.codec.binary.BaseNCodec.getEncodedLength(byte[])
org.apache.commons.codec.language.DoubleMetaphone.handleC(String,DoubleMetaphoneResult,int)	org.apache.commons.codec.language.DoubleMetaphone.handleCH(String,DoubleMetaphoneResult,int)
org.apache.commons.codec.binary.BaseNCodec.encodeAsString(byte[])	org.apache.commons.codec.binary.BaseNCodec.encode(byte[])
org.apache.commons.codec.language.DoubleMetaphone.handleJ(String,DoubleMetaphoneResult,int,boolean)	org.apache.commons.codec.language.DoubleMetaphone.isVowel(char)
org.apache.commons.codec.binary.BinaryByteCodecTest.testEncodeObject()	org.apache.commons.codec.binary.BinaryByteCodec.encode(byte[])
org.apache.commons.codec.binary.Base64OutputStreamTest.testBase64OutputStreamByChunk()	org.apache.commons.codec.binary.Base64OutputStreamTest.testByChunk(byte[],byte[],int,byte[])
org.apache.commons.codec.binary.HexByteTest.testCustomCharsetBadNameEncodeByteArray()	org.apache.commons.codec.binary.HexByteCodec.encode(byte[])
org.apache.commons.codec.language.bm.PhoneticEngine.applyFinalRules(PhonemeBuilder,List<Rule>)	org.apache.commons.codec.language.bm.PhoneticEngine.PhonemeBuilder.append(CharSequence)
org.apache.commons.codec.digest.DigestUtils.sha384Hex(String)	org.apache.commons.codec.digest.DigestUtils.sha384(String)
org.apache.commons.codec.digest.DigestUtils.sha384(byte[])	org.apache.commons.codec.digest.DigestUtils.getSha384Digest()
org.apache.commons.codec.language.DoubleMetaphone.doubleMetaphone(String,boolean)	org.apache.commons.codec.language.DoubleMetaphone.conditionM0(String,int)
org.apache.commons.codec.net.URLCodecStringTest.testDecodeObjects()	org.apache.commons.codec.net.URLCodecStringTest.validateState(URLStringCodec)
org.apache.commons.codec.binary.HexByteTest.testDencodeEmpty()	org.apache.commons.codec.binary.Hex.decode(byte[])
org.apache.commons.codec.language.MetaphoneTest.testExceedLength()	org.apache.commons.codec.language.MetaphoneTest.getMetaphone()
org.apache.commons.codec.language.RefinedSoundexTest.testEncode()	org.apache.commons.codec.language.RefinedSoundexTest.getRefinedSoundex()
org.apache.commons.codec.net.QCodecTest.testInvalidEncoding()	org.apache.commons.codec.net.QCodec.decode(String)
org.apache.commons.codec.binary.Base64OutputStreamTest.testWriteOutOfBounds()	org.apache.commons.codec.binary.BaseNCodecOutputStream.write(byte[],int,int)
org.apache.commons.codec.binary.StringUtilsTest.testGetBytesUtf16Le()	org.apache.commons.codec.binary.StringUtils.getBytesUtf16Le(String)
org.apache.commons.codec.binary.Hex.encode(String)	org.apache.commons.codec.binary.Hex.encodeHex(byte[])
org.apache.commons.codec.binary.BaseNCodecInputStream.read(byte[],int,int)	org.apache.commons.codec.binary.BaseNCodec.encode(byte[],int,int)
org.apache.commons.codec.digest.DigestUtils.sha256Hex(String)	org.apache.commons.codec.binary.Hex.encodeHexString(byte[])
org.apache.commons.codec.language.DoubleMetaphone.handleR(String,DoubleMetaphoneResult,int,boolean)	org.apache.commons.codec.language.DoubleMetaphone.contains(String,int,int,String,String)
org.apache.commons.codec.net.BCodecTest.testNullInput()	org.apache.commons.codec.net.BCodec.doDecoding(byte[])
org.apache.commons.codec.binary.StringUtilsTest.testNewStringUtf16Le()	org.apache.commons.codec.binary.StringUtilsTest.testNewString(String)
org.apache.commons.codec.binary.Base64InputStreamTest.testBase64EmptyInputStreamPemChuckSize()	org.apache.commons.codec.binary.Base64InputStreamTest.testBase64EmptyInputStream(int)
org.apache.commons.codec.language.Metaphone.encode(String)	org.apache.commons.codec.language.Metaphone.metaphone(String)
org.apache.commons.codec.binary.HexCharTest.testHelloWorldLowerCaseHex()	org.apache.commons.codec.binary.Hex.encodeHex(byte[])
org.apache.commons.codec.binary.Base32OutputStreamTest.testBase32EmptyOutputStream(int)	org.apache.commons.codec.binary.Base32OutputStreamTest.testByChunk(byte[],byte[],int,byte[])
org.apache.commons.codec.language.SoundexTest.testBadCharacters()	org.apache.commons.codec.language.SoundexTest.getSoundexEncoder()
org.apache.commons.codec.net.QuotedPrintableStringCodecTest.testInvalidEncoding()	org.apache.commons.codec.net.QuotedPrintableStringCodec.decode(String)
org.apache.commons.codec.net.URLCodecBinaryTest.testDecodeInvalidContent()	org.apache.commons.codec.net.URLCodecBinaryTest.constructString(int[])
org.apache.commons.codec.binary.Base64InputStreamTest.testBase64InputStreamByteByByte()	org.apache.commons.codec.binary.Base64TestData.randomData(int,boolean)
org.apache.commons.codec.binary.Base64Test.testRfc4648Section10Decode()	org.apache.commons.codec.binary.Base64.decodeBase64(String)
org.apache.commons.codec.binary.HexByteTest.testEncodeDecodeRandom()	org.apache.commons.codec.binary.Hex.decode(byte[])
org.apache.commons.codec.language.DoubleMetaphoneTest.testDoubleMetaphone()	org.apache.commons.codec.language.DoubleMetaphoneTest.assertDoubleMetaphone(String,String)
org.apache.commons.codec.net.QuotedPrintableStringCodecTest.testBasicEncodeDecode()	org.apache.commons.codec.net.QuotedPrintableStringCodec.decode(String)
org.apache.commons.codec.binary.HexByteTest.testDencodeEmpty()	org.apache.commons.codec.binary.Hex.decodeHex(char[])
org.apache.commons.codec.binary.StringUtilsTest.testGetBytesUtf16Le()	org.apache.commons.codec.binary.StringUtilsTest.testGetBytesUnchecked(String)
org.apache.commons.codec.net.QuotedPrintableBinaryCodecTest.testDecodeObjects()	org.apache.commons.codec.Decoder.decode(I)
org.apache.commons.codec.language.bm.PhoneticEngine.RulesApplication.invoke()	org.apache.commons.codec.language.bm.Rule.getPhoneme()
org.apache.commons.codec.language.DoubleMetaphone.handleT(String,DoubleMetaphoneResult,int)	org.apache.commons.codec.language.DoubleMetaphone.DoubleMetaphoneResult.append(char)
org.apache.commons.codec.language.Metaphone.metaphone(String)	org.apache.commons.codec.language.Metaphone.isPreviousChar(StringBuffer,int,char)
org.apache.commons.codec.net.URLCodecBinaryTest.testEncodeDecodeNull()	org.apache.commons.codec.Encoder.encode(I)
org.apache.commons.codec.language.RefinedSoundexTest.testGetMappingCodeNonLetter()	org.apache.commons.codec.language.RefinedSoundexTest.getRefinedSoundex()
org.apache.commons.codec.language.MetaphoneTest.testPHTOF()	org.apache.commons.codec.language.MetaphoneTest.getMetaphone()
org.apache.commons.codec.language.bm.Languages.langResourceName(NameType)	org.apache.commons.codec.language.bm.NameType.getName()
org.apache.commons.codec.language.DoubleMetaphone.contains(String,int,int,String,String,String)	org.apache.commons.codec.language.DoubleMetaphone.contains(String,int,int,String[])
org.apache.commons.codec.binary.Base64Test.testUUID()	org.apache.commons.codec.binary.Hex.encodeHexString(byte[])
org.apache.commons.codec.language.bm.Rule.getInstance(NameType,RuleType,String)	org.apache.commons.codec.language.bm.RuleType.getName()
org.apache.commons.codec.language.SoundexTest.testEncodeBatch2()	org.apache.commons.codec.language.Soundex.encode(String)
org.apache.commons.codec.binary.StringUtilsTest.testNewStringUtf8()	org.apache.commons.codec.binary.StringUtilsTest.testNewString(String)
org.apache.commons.codec.language.DoubleMetaphone.handleD(String,DoubleMetaphoneResult,int)	org.apache.commons.codec.language.DoubleMetaphone.contains(String,int,int,String)
org.apache.commons.codec.binary.StringUtilsTest.testGetBytesUncheckedBadName()	org.apache.commons.codec.binary.StringUtils.getBytesUnchecked(String,String)
org.apache.commons.codec.digest.DigestUtils.sha256Hex(InputStream)	org.apache.commons.codec.digest.DigestUtils.sha256(InputStream)
org.apache.commons.codec.language.DoubleMetaphone.handleCH(String,DoubleMetaphoneResult,int)	org.apache.commons.codec.language.DoubleMetaphone.DoubleMetaphoneResult.append(char)
org.apache.commons.codec.binary.Base32InputStreamTest.testBase32EmptyInputStream(int)	org.apache.commons.codec.binary.Base32InputStreamTest.testByteByByte(byte[],byte[],int,byte[])
org.apache.commons.codec.binary.Base64Test.testConstructor_Int_ByteArray_Boolean_UrlSafe()	org.apache.commons.codec.binary.BaseNCodec.encode(byte[])
org.apache.commons.codec.language.DoubleMetaphone.handleSC(String,DoubleMetaphoneResult,int)	org.apache.commons.codec.language.DoubleMetaphone.DoubleMetaphoneResult.append(char)
org.apache.commons.codec.binary.BaseNCodec.encodeToString(byte[])	org.apache.commons.codec.binary.StringUtils.newStringUtf8(byte[])
org.apache.commons.codec.language.DoubleMetaphone.handleG(String,DoubleMetaphoneResult,int,boolean)	org.apache.commons.codec.language.DoubleMetaphone.contains(String,int,int,String,String,String)
org.apache.commons.codec.net.URLCodecBinaryTest.testDecodeObjects()	org.apache.commons.codec.net.URLCodecBinaryTest.validateState(URLBinaryCodec)
org.apache.commons.codec.binary.Base64OutputStreamTest.testBase64EmptyOutputStream(int)	org.apache.commons.codec.binary.Base64OutputStreamTest.testByteByByte(byte[],byte[],int,byte[])
org.apache.commons.codec.digest.DigestUtils.sha512(byte[])	org.apache.commons.codec.digest.DigestUtils.getSha512Digest()
org.apache.commons.codec.language.DoubleMetaphone.handleG(String,DoubleMetaphoneResult,int,boolean)	org.apache.commons.codec.language.DoubleMetaphone.DoubleMetaphoneResult.append(char,char)
org.apache.commons.codec.binary.StringUtilsTest.testGetBytesUsAscii()	org.apache.commons.codec.binary.StringUtils.getBytesUsAscii(String)
org.apache.commons.codec.binary.StringUtilsTest.testNewStringIso8859_1()	org.apache.commons.codec.binary.StringUtilsTest.testNewString(String)
org.apache.commons.codec.binary.Base64InputStreamTest.testBase64InputStreamByteByByte()	org.apache.commons.codec.binary.Base64InputStreamTest.testByteByByte(byte[],byte[],int,byte[])
org.apache.commons.codec.binary.Base64Test.testDecodeEncode(String)	org.apache.commons.codec.binary.StringUtils.newStringUsAscii(byte[])
org.apache.commons.codec.language.DoubleMetaphoneTest.assertDoubleMetaphone(String,String)	org.apache.commons.codec.language.DoubleMetaphoneTest.getDoubleMetaphone()
org.apache.commons.codec.binary.Base64Test.testByteToStringVariations()	org.apache.commons.codec.binary.StringUtils.getBytesUtf8(String)
org.apache.commons.codec.net.QuotedPrintableStringCodec.decode(String,String)	org.apache.commons.codec.binary.StringUtils.getBytesUsAscii(String)
org.apache.commons.codec.digest.DigestUtils.md5Hex(String)	org.apache.commons.codec.digest.DigestUtils.md5(String)
org.apache.commons.codec.binary.HexCharTest.testHelloWorldUpperCaseHex()	org.apache.commons.codec.binary.StringUtils.getBytesUtf8(String)
org.apache.commons.codec.language.SoundexTest.testHWRuleEx1()	org.apache.commons.codec.language.SoundexTest.getSoundexEncoder()
org.apache.commons.codec.binary.Base64Codec13Test.testStaticEncode()	org.apache.commons.codec.binary.Base64Codec13Test.utf8(String)
org.apache.commons.codec.binary.HexCharTest.testEncodeDecodeRandom()	org.apache.commons.codec.binary.Hex.encodeHex(byte[])
org.apache.commons.codec.StringEncoderAbstractTest.testLocaleIndependence()	org.apache.commons.codec.StringEncoder.encode(String)
org.apache.commons.codec.net.BCodecTest.testNullInput()	org.apache.commons.codec.net.BCodec.doEncoding(byte[])
org.apache.commons.codec.binary.Base64Test.testDecodePadMarkerIndex2()	org.apache.commons.codec.binary.Base64.decodeBase64(byte[])
org.apache.commons.codec.binary.Base64.isBase64(byte[])	org.apache.commons.codec.binary.Base64.isBase64(byte)
org.apache.commons.codec.net.URLCodecStringTest.testDecodeInvalid()	org.apache.commons.codec.net.URLCodecStringTest.validateState(URLStringCodec)
org.apache.commons.codec.StringEncoderComparatorTest.testComparatorWithSoundex()	org.apache.commons.codec.StringEncoderComparator.compare(String,String)
org.apache.commons.codec.language.DoubleMetaphone.handleJ(String,DoubleMetaphoneResult,int,boolean)	org.apache.commons.codec.language.DoubleMetaphone.contains(String,int,int,String[])
org.apache.commons.codec.binary.Base32OutputStreamTest.testBase32OutputStreamByteByByte()	org.apache.commons.codec.binary.Base32TestData.randomData(BaseNCodec,int)
org.apache.commons.codec.language.DoubleMetaphoneTest.testIsDoubleMetaphoneEqualBasic()	org.apache.commons.codec.language.DoubleMetaphoneTest.doubleMetaphoneEqualTest(String[][],boolean)
org.apache.commons.codec.language.SoundexTest.testUsMappingOWithDiaeresis()	org.apache.commons.codec.language.SoundexTest.getSoundexEncoder()
org.apache.commons.codec.binary.StringUtils.getBytesUnchecked(String,String)	org.apache.commons.codec.binary.StringUtils.newIllegalStateException(String,UnsupportedEncodingException)
org.apache.commons.codec.binary.HexByteTest.testDecodeArrayOddCharacters()	org.apache.commons.codec.binary.Hex.decode(byte[])
org.apache.commons.codec.digest.DigestUtilsTest.testShaHex()	org.apache.commons.codec.digest.DigestUtils.shaHex(InputStream)
org.apache.commons.codec.binary.HexByteTest.testEncodeDecodeRandom()	org.apache.commons.codec.binary.Hex.encodeHex(byte[])
org.apache.commons.codec.language.ColognePhonetic.colognePhonetic(String)	org.apache.commons.codec.language.ColognePhonetic.CologneInputBuffer.removeNext()
org.apache.commons.codec.language.ColognePhonetic.colognePhonetic(String)	org.apache.commons.codec.language.ColognePhonetic.CologneInputBuffer.addLeft(char)
org.apache.commons.codec.digest.DigestUtilsTest.testInternalNoSuchAlgorithmException()	org.apache.commons.codec.digest.DigestUtils.getDigest(String)
org.apache.commons.codec.language.MetaphoneTest.testTIOAndTIAToX()	org.apache.commons.codec.language.Metaphone.metaphone(String)
org.apache.commons.codec.language.SoundexTest.testSoundexUtilsNullBehaviour()	org.apache.commons.codec.language.SoundexUtils.clean(String)
org.apache.commons.codec.binary.HexCharTest.testEncodeDecodeRandom()	org.apache.commons.codec.binary.Hex.decodeHex(char[])
org.apache.commons.codec.net.URLStringCodec.decode(String)	org.apache.commons.codec.net.URLStringCodec.decode(String,String)
org.apache.commons.codec.net.RFC1522CodecTest.assertExpectedDecoderException(String)	org.apache.commons.codec.net.RFC1522Codec.decodeText(String)
org.apache.commons.codec.net.QuotedPrintableStringCodec.encode(String,String)	org.apache.commons.codec.net.QuotedPrintableCodec.encode(byte[])
org.apache.commons.codec.binary.Base64Test.testStringToByteVariations()	org.apache.commons.codec.binary.StringUtils.newStringUtf8(byte[])
org.apache.commons.codec.language.SoundexTest.testMsSqlServer3()	org.apache.commons.codec.language.SoundexTest.getSoundexEncoder()
org.apache.commons.codec.language.DoubleMetaphone.conditionCH1(String,int)	org.apache.commons.codec.language.DoubleMetaphone.contains(String,int,int,String,String)
org.apache.commons.codec.net.URLCodecBinaryTest.testEncodeObjects()	org.apache.commons.codec.Encoder.encode(I)
org.apache.commons.codec.binary.BinaryByteCodecTest.testToAsciiString()	org.apache.commons.codec.binary.BinaryCodec.toAsciiString(byte[])
org.apache.commons.codec.digest.DigestUtilsTest.testMd5Hex()	org.apache.commons.codec.digest.DigestUtils.md5Hex(byte[])
org.apache.commons.codec.StringEncoderAbstractTest.testEncodeEmpty()	org.apache.commons.codec.StringEncoderAbstractTest.getStringEncoder()
org.apache.commons.codec.language.bm.PhoneticEngine.encode(String,LanguageSet)	org.apache.commons.codec.language.bm.PhoneticEngine.cacheSubSequence(CharSequence)
org.apache.commons.codec.language.DoubleMetaphone.handleZ(String,DoubleMetaphoneResult,int,boolean)	org.apache.commons.codec.language.DoubleMetaphone.DoubleMetaphoneResult.append(String,String)
org.apache.commons.codec.language.DoubleMetaphone.conditionM0(String,int)	org.apache.commons.codec.language.DoubleMetaphone.contains(String,int,int,String)
org.apache.commons.codec.binary.Base64Codec13Test.testStaticDecode()	org.apache.commons.codec.binary.Base64.decodeBase64(byte[])
org.apache.commons.codec.binary.HexCharTest.testHelloWorldUpperCaseHex()	org.apache.commons.codec.binary.Hex.encodeHex(byte[])
org.apache.commons.codec.language.bm.RuleTest.testPhonemeComparedToLaterIsNegative()	org.apache.commons.codec.language.bm.RuleTest.makePhonemes()
org.apache.commons.codec.digest.DigestUtilsTest.testSha256()	org.apache.commons.codec.digest.DigestUtils.sha256Hex(String)
org.apache.commons.codec.binary.Base64.isBase64(String)	org.apache.commons.codec.binary.StringUtils.getBytesUtf8(String)
org.apache.commons.codec.binary.BaseNCodec.decode(String)	org.apache.commons.codec.binary.BaseNCodec.decode(byte[])
org.apache.commons.codec.language.DoubleMetaphone.doubleMetaphone(String,boolean)	org.apache.commons.codec.language.DoubleMetaphone.charAt(String,int)
org.apache.commons.codec.binary.Base64Test.testEncodeDecodeSmall()	org.apache.commons.codec.binary.Base64.encodeBase64(byte[])
org.apache.commons.codec.StringEncoderAbstractTest.checkEncoding(String,String)	org.apache.commons.codec.StringEncoderAbstractTest.getStringEncoder()
org.apache.commons.codec.language.DoubleMetaphone.doubleMetaphone(String,boolean)	org.apache.commons.codec.language.DoubleMetaphone.isSilentStart(String)
org.apache.commons.codec.binary.Base64.encodeBase64(byte[],boolean,boolean)	org.apache.commons.codec.binary.Base64.encodeBase64(byte[],boolean,boolean,int)
org.apache.commons.codec.digest.DigestUtilsTest.testMD5HexLength()	org.apache.commons.codec.digest.DigestUtilsTest.getBytesUtf8(String)
org.apache.commons.codec.language.DoubleMetaphoneTest.doubleMetaphoneEqualTest(String[][],boolean)	org.apache.commons.codec.language.DoubleMetaphone.isDoubleMetaphoneEqual(String,String)
org.apache.commons.codec.binary.HexCharTest.testEncodeEmpty()	org.apache.commons.codec.binary.Hex.encode(String)
org.apache.commons.codec.binary.StringUtilsTest.testGetBytesUnchecked(String)	org.apache.commons.codec.binary.StringUtils.getBytesUnchecked(String,String)
org.apache.commons.codec.digest.DigestUtils.sha512Hex(String)	org.apache.commons.codec.digest.DigestUtils.sha512(String)
org.apache.commons.codec.net.RFC1522Codec.decodeText(String)	org.apache.commons.codec.net.RFC1522Codec.doDecoding(byte[])
org.apache.commons.codec.binary.Base64Codec13Test.testBinaryEncoder()	org.apache.commons.codec.binary.Base64Codec13Test.utf8(String)
org.apache.commons.codec.language.DoubleMetaphone.conditionCH1(String,int)	org.apache.commons.codec.language.DoubleMetaphone.contains(String,int,int,String[])
org.apache.commons.codec.binary.Base64Test.testRfc4648Section10Decode()	org.apache.commons.codec.binary.StringUtils.newStringUsAscii(byte[])
org.apache.commons.codec.language.bm.Rule.pattern(String)	org.apache.commons.codec.language.bm.Rule.startsWith(CharSequence,CharSequence)
org.apache.commons.codec.binary.BinaryCharCodecTest.testFromAsciiByteArray()	org.apache.commons.codec.binary.BinaryCodec.fromAscii(byte[])
org.apache.commons.codec.language.RefinedSoundexTest.getRefinedSoundex()	org.apache.commons.codec.StringEncoderAbstractTest.getStringEncoder()
org.apache.commons.codec.language.bm.Rule.createScanner(NameType,RuleType,String)	org.apache.commons.codec.language.bm.Rule.createResourceName(NameType,RuleType,String)
org.apache.commons.codec.net.BCodecTest.testUTF8RoundTrip()	org.apache.commons.codec.net.BCodec.encode(String)
org.apache.commons.codec.language.DoubleMetaphone.isDoubleMetaphoneEqual(String,String,boolean)	org.apache.commons.codec.language.DoubleMetaphone.doubleMetaphone(String,boolean)
org.apache.commons.codec.language.DoubleMetaphone.handleZ(String,DoubleMetaphoneResult,int,boolean)	org.apache.commons.codec.language.DoubleMetaphone.contains(String,int,int,String,String,String)
org.apache.commons.codec.language.SoundexTest.testHWRuleEx1()	org.apache.commons.codec.language.Soundex.encode(String)
org.apache.commons.codec.digest.DigestUtils.sha512(InputStream)	org.apache.commons.codec.digest.DigestUtils.getSha512Digest()
org.apache.commons.codec.net.URLCodecStringTest.testEncodeObjects()	org.apache.commons.codec.net.URLCodec.encode(byte[])
org.apache.commons.codec.net.QuotedPrintableStringCodecTest.testSoftLineBreakEncode()	org.apache.commons.codec.net.QuotedPrintableStringCodec.encode(String)
org.apache.commons.codec.binary.Base64Test.testCodeInteger2()	org.apache.commons.codec.binary.Base64.encodeInteger(BigInteger)
org.apache.commons.codec.digest.DigestUtils.sha256(InputStream)	org.apache.commons.codec.digest.DigestUtils.getSha256Digest()
org.apache.commons.codec.net.QuotedPrintableStringCodecTest.testDefaultEncoding()	org.apache.commons.codec.net.QuotedPrintableStringCodec.encode(String,String)
org.apache.commons.codec.binary.Base32OutputStreamTest.testBase32OutputStreamByteByByte()	org.apache.commons.codec.binary.StringUtils.getBytesUtf8(String)
org.apache.commons.codec.binary.Base64Test.testSingletons()	org.apache.commons.codec.binary.Base64.decodeBase64(byte[])
org.apache.commons.codec.language.MetaphoneTest.testDiscardOfSilentGN()	org.apache.commons.codec.language.MetaphoneTest.getMetaphone()
org.apache.commons.codec.language.ColognePhoneticTest.testHyphen()	org.apache.commons.codec.StringEncoderAbstractTest.checkEncodings(String[][])
org.apache.commons.codec.binary.HexByteTest.testEncodeDecodeRandom()	org.apache.commons.codec.binary.HexByteCodec.encode(byte[])
org.apache.commons.codec.language.bm.BeiderMorseEncoderTest.testNegativeIndexForRuleMatchIndexOutOfBoundsException()	org.apache.commons.codec.language.bm.Rule.patternAndContextMatches(CharSequence,int)
org.apache.commons.codec.binary.Base64.encodeBase64(byte[],boolean,boolean,int)	org.apache.commons.codec.binary.BaseNCodec.encode(byte[])
org.apache.commons.codec.language.bm.PhoneticEngine.encode(String,LanguageSet)	org.apache.commons.codec.language.bm.PhoneticEngine.RulesApplication.getI()
org.apache.commons.codec.language.DoubleMetaphone.handleGH(String,DoubleMetaphoneResult,int)	org.apache.commons.codec.language.DoubleMetaphone.charAt(String,int)
org.apache.commons.codec.net.URLCodecStringTest.testInvalidEncoding()	org.apache.commons.codec.net.URLStringCodec.encode(String)
org.apache.commons.codec.binary.BaseNCodecOutputStream.close()	org.apache.commons.codec.binary.BaseNCodecOutputStream.flush()
org.apache.commons.codec.BinaryEncoderAbstractTest.testEncodeEmpty()	org.apache.commons.codec.BinaryEncoderAbstractTest.makeEncoder()
org.apache.commons.codec.language.DoubleMetaphone.handleGH(String,DoubleMetaphoneResult,int)	org.apache.commons.codec.language.DoubleMetaphone.contains(String,int,int,String,String,String,String,String)
org.apache.commons.codec.binary.Base64Test.testEncodeDecodeSmall()	org.apache.commons.codec.binary.Base64.decodeBase64(byte[])
org.apache.commons.codec.language.MetaphoneTest.assertMetaphoneEqual(String[][])	org.apache.commons.codec.language.MetaphoneTest.getMetaphone()
org.apache.commons.codec.language.MetaphoneTest.testIsMetaphoneEqualRay()	org.apache.commons.codec.language.MetaphoneTest.assertIsMetaphoneEqual(String,String[])
org.apache.commons.codec.binary.Hex.decode(String)	org.apache.commons.codec.binary.Hex.decodeHex(char[])
org.apache.commons.codec.language.DoubleMetaphone.handleH(String,DoubleMetaphoneResult,int)	org.apache.commons.codec.language.DoubleMetaphone.DoubleMetaphoneResult.append(char)
org.apache.commons.codec.binary.Base64TestData.streamToBytes(InputStream,byte[])	org.apache.commons.codec.binary.Base64TestData.resizeArray(byte[])
org.apache.commons.codec.language.bm.BeiderMorseEncoder.setNameType(NameType)	org.apache.commons.codec.language.bm.PhoneticEngine.getRuleType()
org.apache.commons.codec.language.DoubleMetaphoneTest.testDoubleMetaphone()	org.apache.commons.codec.language.DoubleMetaphoneTest.assertDoubleMetaphoneAlt(String,String)
org.apache.commons.codec.digest.DigestUtils.sha384Hex(String)	org.apache.commons.codec.binary.Hex.encodeHexString(byte[])
org.apache.commons.codec.binary.HexByteTest.testCustomCharset(String,String)	org.apache.commons.codec.binary.Hex.decode(byte[])
org.apache.commons.codec.language.MetaphoneTest.testWordEndingInMB()	org.apache.commons.codec.language.Metaphone.metaphone(String)
org.apache.commons.codec.language.bm.BeiderMorseEncoder.setConcat(boolean)	org.apache.commons.codec.language.bm.PhoneticEngine.getRuleType()
org.apache.commons.codec.language.DoubleMetaphone.handleW(String,DoubleMetaphoneResult,int)	org.apache.commons.codec.language.DoubleMetaphone.contains(String,int,int,String)
org.apache.commons.codec.digest.DigestUtils.sha256Hex(byte[])	org.apache.commons.codec.digest.DigestUtils.sha256(byte[])
org.apache.commons.codec.net.URLCodecStringTest.testDecodeObjects()	org.apache.commons.codec.net.URLCodec.decode(byte[])
org.apache.commons.codec.net.URLCodecStringTest.testEncodeNull()	org.apache.commons.codec.net.URLCodecStringTest.validateState(URLStringCodec)
org.apache.commons.codec.binary.HexCharTest.testDecodeHexOddCharacters5()	org.apache.commons.codec.binary.HexCharTest.checkDecodeHexOddCharacters(char[])
org.apache.commons.codec.binary.HexByteTest.testEncodeEmpty()	org.apache.commons.codec.binary.Hex.encodeHex(byte[])
org.apache.commons.codec.binary.Base64Codec13Test.testBinaryDecoder()	org.apache.commons.codec.BinaryDecoder.decode(byte[])
org.apache.commons.codec.binary.HexByteCodec.encode(byte[])	org.apache.commons.codec.binary.Hex.encodeHexString(byte[])
org.apache.commons.codec.language.DoubleMetaphone.handleW(String,DoubleMetaphoneResult,int)	org.apache.commons.codec.language.DoubleMetaphone.DoubleMetaphoneResult.append(char,char)
org.apache.commons.codec.binary.Base64Codec13Test.testDecoder()	org.apache.commons.codec.Decoder.decode(I)
org.apache.commons.codec.binary.StringUtilsTest.testGetBytesUtf8()	org.apache.commons.codec.binary.StringUtils.getBytesUtf8(String)
org.apache.commons.codec.binary.Base64.isBase64(String)	org.apache.commons.codec.binary.Base64.isBase64(byte[])
org.apache.commons.codec.language.SoundexTest.testSoundexUtilsNullBehaviour()	org.apache.commons.codec.language.SoundexUtils.differenceEncoded(String,String)
org.apache.commons.codec.language.RefinedSoundexTest.testNewInstance2()	org.apache.commons.codec.language.RefinedSoundex.soundex(String)
org.apache.commons.codec.binary.Base64Test.testUUID()	org.apache.commons.codec.binary.StringUtils.newStringUtf8(byte[])
org.apache.commons.codec.language.bm.PhoneticEngine.applyFinalRules(PhonemeBuilder,List<Rule>)	org.apache.commons.codec.language.bm.PhoneticEngine.cacheSubSequence(CharSequence)
org.apache.commons.codec.net.QCodec.doEncoding(byte[])	org.apache.commons.codec.net.QuotedPrintableCodec.encodeQuotedPrintable(BitSet,byte[])
org.apache.commons.codec.language.bm.PhoneticEngine.encode(String)	org.apache.commons.codec.language.bm.Lang.guessLanguages(String)
org.apache.commons.codec.binary.Base64Test.testCodeInteger4()	org.apache.commons.codec.binary.Base64.encodeInteger(BigInteger)
org.apache.commons.codec.language.DoubleMetaphone.handleG(String,DoubleMetaphoneResult,int,boolean)	org.apache.commons.codec.language.DoubleMetaphone.contains(String,int,int,String,String)
org.apache.commons.codec.language.DoubleMetaphoneTest.doubleMetaphoneEqualTest(String[][],boolean)	org.apache.commons.codec.language.DoubleMetaphoneTest.getDoubleMetaphone()
org.apache.commons.codec.language.DoubleMetaphone.handleC(String,DoubleMetaphoneResult,int)	org.apache.commons.codec.language.DoubleMetaphone.DoubleMetaphoneResult.append(char)
org.apache.commons.codec.binary.Base32InputStreamTest.testReadNull()	org.apache.commons.codec.binary.BaseNCodecInputStream.read(byte[],int,int)
org.apache.commons.codec.binary.BinaryCharCodecTest.testEncodeObjectNull()	org.apache.commons.codec.binary.BinaryCharCodec.encode(byte[])
org.apache.commons.codec.language.ColognePhonetic.colognePhonetic(String)	org.apache.commons.codec.language.ColognePhonetic.CologneBuffer.toString()
org.apache.commons.codec.language.MetaphoneTest.testIsMetaphoneEqualAero()	org.apache.commons.codec.language.MetaphoneTest.assertIsMetaphoneEqual(String,String[])
org.apache.commons.codec.net.QCodecTest.testEncodeStringWithNull()	org.apache.commons.codec.net.QCodec.encode(String,String)
org.apache.commons.codec.binary.Base64OutputStreamTest.testBase64OutputStreamByChunk()	org.apache.commons.codec.binary.StringUtils.getBytesUtf8(String)
org.apache.commons.codec.net.URLCodecStringTest.testEncodeUrlWithNullBitSet()	org.apache.commons.codec.net.URLCodecStringTest.validateState(URLStringCodec)
org.apache.commons.codec.language.MetaphoneTest.testIsMetaphoneEqualParis()	org.apache.commons.codec.language.MetaphoneTest.assertIsMetaphoneEqual(String,String[])
org.apache.commons.codec.language.DoubleMetaphone.doubleMetaphone(String,boolean)	org.apache.commons.codec.language.DoubleMetaphone.cleanInput(String)
org.apache.commons.codec.language.DoubleMetaphone.handleCC(String,DoubleMetaphoneResult,int)	org.apache.commons.codec.language.DoubleMetaphone.DoubleMetaphoneResult.append(String)
org.apache.commons.codec.language.DoubleMetaphone.DoubleMetaphoneResult.append(String)	org.apache.commons.codec.language.DoubleMetaphone.DoubleMetaphoneResult.appendAlternate(String)
org.apache.commons.codec.language.bm.BeiderMorseEncoderTest.assertNotEmpty(BeiderMorseEncoder,String)	org.apache.commons.codec.language.bm.BeiderMorseEncoder.encode(String)
org.apache.commons.codec.binary.BaseNCodecOutputStream.write(int)	org.apache.commons.codec.binary.BaseNCodecOutputStream.write(byte[],int,int)
org.apache.commons.codec.binary.Base64Test.testKnownEncodings()	org.apache.commons.codec.binary.Base64.encodeBase64Chunked(byte[])
org.apache.commons.codec.binary.HexByteTest.testDecodeHexOddCharacters1()	org.apache.commons.codec.binary.HexByteTest.checkDecodeHexOddCharacters(char[])
org.apache.commons.codec.language.DoubleMetaphone.handleCC(String,DoubleMetaphoneResult,int)	org.apache.commons.codec.language.DoubleMetaphone.contains(String,int,int,String,String)
org.apache.commons.codec.binary.HexCharTest.testCustomCharset(String,String)	org.apache.commons.codec.binary.HexCharTest.log(String)
org.apache.commons.codec.binary.BaseNCodec.isInAlphabet(byte[],boolean)	org.apache.commons.codec.binary.BaseNCodec.isInAlphabet(byte)
org.apache.commons.codec.language.bm.PhoneticEngine.RulesApplication.invoke()	org.apache.commons.codec.language.bm.Rule.getPattern()
org.apache.commons.codec.digest.DigestUtils.sha512(InputStream)	org.apache.commons.codec.digest.DigestUtils.digest(MessageDigest,InputStream)
org.apache.commons.codec.binary.Base64Test.testBase64()	org.apache.commons.codec.binary.StringUtils.getBytesUtf8(String)
org.apache.commons.codec.language.RefinedSoundexTest.testEncode()	org.apache.commons.codec.language.RefinedSoundex.encode(String)
org.apache.commons.codec.language.bm.RuleTest.testPhonemeComparedToLaterIsNegative()	org.apache.commons.codec.language.bm.Rule.Phoneme.getPhonemeText()
org.apache.commons.codec.language.DoubleMetaphone.handleSC(String,DoubleMetaphoneResult,int)	org.apache.commons.codec.language.DoubleMetaphone.DoubleMetaphoneResult.append(char,char)
org.apache.commons.codec.language.DoubleMetaphone.contains(String,int,int,String,String)	org.apache.commons.codec.language.DoubleMetaphone.contains(String,int,int,String[])
org.apache.commons.codec.language.DoubleMetaphone.encode(String)	org.apache.commons.codec.language.DoubleMetaphone.doubleMetaphone(String)
org.apache.commons.codec.digest.DigestUtils.md5Hex(byte[])	org.apache.commons.codec.digest.DigestUtils.md5(byte[])
org.apache.commons.codec.binary.Base64Test.testSingletons()	org.apache.commons.codec.binary.Base64.encodeBase64(byte[])
org.apache.commons.codec.language.DoubleMetaphone.handleCC(String,DoubleMetaphoneResult,int)	org.apache.commons.codec.language.DoubleMetaphone.DoubleMetaphoneResult.append(char)
org.apache.commons.codec.language.bm.BeiderMorseEncoder.encode(String)	org.apache.commons.codec.language.bm.PhoneticEngine.encode(String)
org.apache.commons.codec.digest.DigestUtilsTest.testSha384()	org.apache.commons.codec.digest.DigestUtils.sha384Hex(InputStream)
org.apache.commons.codec.binary.HexByteTest.testCustomCharsetToString()	org.apache.commons.codec.binary.Hex.toString()
org.apache.commons.codec.language.bm.BeiderMorseEncoderTest.testAsciiEncodeNotEmpty2Letters()	org.apache.commons.codec.language.bm.BeiderMorseEncoderTest.createGenericApproxEncoder()
org.apache.commons.codec.net.QCodecTest.testUnsafeEncodeDecode()	org.apache.commons.codec.net.QCodec.decode(String)
org.apache.commons.codec.language.bm.PhoneticEngine.encode(String,LanguageSet)	org.apache.commons.codec.language.bm.PhoneticEngine.join(Iterable<String>,String)
org.apache.commons.codec.binary.Base32InputStreamTest.testBase32EmptyInputStream(int)	org.apache.commons.codec.binary.Base32InputStreamTest.testByChunk(byte[],byte[],int,byte[])
org.apache.commons.codec.language.SoundexTest.testEncodeIgnoreApostrophes()	org.apache.commons.codec.StringEncoderAbstractTest.checkEncodingVariations(String,String[])
org.apache.commons.codec.binary.Base64Codec13Test.testStaticEncode()	org.apache.commons.codec.binary.Base64.encodeBase64(byte[])
org.apache.commons.codec.language.RefinedSoundex.encode(String)	org.apache.commons.codec.language.RefinedSoundex.soundex(String)
org.apache.commons.codec.net.URLCodecStringTest.testBasicEncodeDecode()	org.apache.commons.codec.net.URLCodecStringTest.validateState(URLStringCodec)
org.apache.commons.codec.language.DoubleMetaphone.conditionCH0(String,int)	org.apache.commons.codec.language.DoubleMetaphone.contains(String,int,int,String,String,String,String)
org.apache.commons.codec.language.DoubleMetaphone.handleL(String,DoubleMetaphoneResult,int)	org.apache.commons.codec.language.DoubleMetaphone.DoubleMetaphoneResult.append(char)
org.apache.commons.codec.binary.HexByteCodec.encode(byte[])	org.apache.commons.codec.binary.StringUtils.getBytesUnchecked(String,String)
org.apache.commons.codec.binary.Base64Codec13Test.testBinaryEncoder()	org.apache.commons.codec.BinaryEncoder.encode(byte[])
org.apache.commons.codec.language.Caverphone2Test.testCaverphoneRevisitedRandomNameKLN1111111()	org.apache.commons.codec.StringEncoderAbstractTest.checkEncodingVariations(String,String[])
org.apache.commons.codec.digest.DigestUtils.sha256(InputStream)	org.apache.commons.codec.digest.DigestUtils.digest(MessageDigest,InputStream)
org.apache.commons.codec.digest.DigestUtils.sha(InputStream)	org.apache.commons.codec.digest.DigestUtils.getShaDigest()
org.apache.commons.codec.binary.Base64OutputStreamTest.testBase64OutputStreamByChunk()	org.apache.commons.codec.binary.Base64TestData.randomData(int,boolean)
org.apache.commons.codec.language.SoundexTest.testEncodeIgnoreTrimmable()	org.apache.commons.codec.language.Soundex.encode(String)
org.apache.commons.codec.binary.BaseNCodecOutputStream.write(byte[],int,int)	org.apache.commons.codec.binary.BaseNCodec.encode(byte[],int,int)
org.apache.commons.codec.language.bm.BeiderMorseEncoderTest.testAsciiEncodeNotEmpty1Letter()	org.apache.commons.codec.language.bm.BeiderMorseEncoderTest.assertNotEmpty(BeiderMorseEncoder,String)
org.apache.commons.codec.language.ColognePhonetic.colognePhonetic(String)	org.apache.commons.codec.language.ColognePhonetic.arrayContains(char[],char)
org.apache.commons.codec.language.bm.PhoneticEngine.PhonemeBuilder.apply(PhonemeExpr)	org.apache.commons.codec.language.bm.Rule.Phoneme.join(Phoneme)
org.apache.commons.codec.binary.BinaryCharCodecTest.testEncodeObject()	org.apache.commons.codec.binary.BinaryCharCodec.encode(byte[])
org.apache.commons.codec.language.bm.PhoneticEngine.encode(String,LanguageSet)	org.apache.commons.codec.language.bm.PhoneticEngine.RulesApplication.getPhonemeBuilder()
org.apache.commons.codec.binary.Base64Test.testPairs()	org.apache.commons.codec.binary.Base64.decodeBase64(byte[])
org.apache.commons.codec.binary.Base32Test.testRandomBytesHex()	org.apache.commons.codec.binary.BaseNCodec.getEncodedLength(byte[])
org.apache.commons.codec.binary.StringUtils.newStringUtf16(byte[])	org.apache.commons.codec.binary.StringUtils.newString(byte[],String)
org.apache.commons.codec.binary.Base64.encode(byte[],int,int)	org.apache.commons.codec.binary.BaseNCodec.ensureBufferSize(int)
org.apache.commons.codec.binary.StringUtils.getBytesUtf16(String)	org.apache.commons.codec.binary.StringUtils.getBytesUnchecked(String,String)
org.apache.commons.codec.language.SoundexTest.testHWRuleEx3()	org.apache.commons.codec.language.Soundex.encode(String)
org.apache.commons.codec.binary.Base32Test.testRandomBytes()	org.apache.commons.codec.binary.BaseNCodec.getEncodedLength(byte[])
org.apache.commons.codec.digest.DigestUtils.sha512Hex(byte[])	org.apache.commons.codec.digest.DigestUtils.sha512(byte[])
org.apache.commons.codec.net.URLCodecStringTest.testEncodeDecodeNull()	org.apache.commons.codec.net.URLCodecStringTest.validateState(URLStringCodec)
org.apache.commons.codec.language.DoubleMetaphone.doubleMetaphone(String,boolean)	org.apache.commons.codec.language.DoubleMetaphone.handleJ(String,DoubleMetaphoneResult,int,boolean)
org.apache.commons.codec.language.ColognePhonetic.colognePhonetic(String)	org.apache.commons.codec.language.ColognePhonetic.CologneInputBuffer.getNextChar()
org.apache.commons.codec.binary.BaseNCodecOutputStream.close()	org.apache.commons.codec.binary.BaseNCodec.encode(byte[],int,int)
org.apache.commons.codec.language.bm.PhoneticEngine.applyFinalRules(PhonemeBuilder,List<Rule>)	org.apache.commons.codec.language.bm.PhoneticEngine.PhonemeBuilder.getPhonemes()
org.apache.commons.codec.StringEncoderAbstractTest.testEncodeEmpty()	org.apache.commons.codec.Encoder.encode(I)
org.apache.commons.codec.language.DoubleMetaphone.DoubleMetaphoneResult.append(char)	org.apache.commons.codec.language.DoubleMetaphone.DoubleMetaphoneResult.appendPrimary(char)
org.apache.commons.codec.binary.BaseNCodec.decode(byte[])	org.apache.commons.codec.binary.BaseNCodec.readResults(byte[],int,int)
org.apache.commons.codec.language.DoubleMetaphone.handleC(String,DoubleMetaphoneResult,int)	org.apache.commons.codec.language.DoubleMetaphone.contains(String,int,int,String,String,String)
org.apache.commons.codec.net.QuotedPrintableStringCodecTest.testUTF8RoundTrip()	org.apache.commons.codec.net.QuotedPrintableStringCodec.decode(String,String)
org.apache.commons.codec.language.bm.PhoneticEngine.RulesApplication.invoke()	org.apache.commons.codec.language.bm.PhoneticEngine.PhonemeBuilder.apply(PhonemeExpr)
org.apache.commons.codec.language.SoundexTest.testMsSqlServer2()	org.apache.commons.codec.StringEncoderAbstractTest.checkEncodingVariations(String,String[])
org.apache.commons.codec.language.bm.PhoneticEngine.encode(String,LanguageSet)	org.apache.commons.codec.language.bm.Rule.getInstance(NameType,RuleType,String)
org.apache.commons.codec.binary.Base64Test.testKnownEncodings()	org.apache.commons.codec.binary.Base64.encodeBase64(byte[])
org.apache.commons.codec.language.DoubleMetaphone.handleJ(String,DoubleMetaphoneResult,int,boolean)	org.apache.commons.codec.language.DoubleMetaphone.charAt(String,int)
org.apache.commons.codec.language.MetaphoneTest.testMetaphone()	org.apache.commons.codec.language.MetaphoneTest.getMetaphone()
org.apache.commons.codec.language.DoubleMetaphone.handleP(String,DoubleMetaphoneResult,int)	org.apache.commons.codec.language.DoubleMetaphone.charAt(String,int)
org.apache.commons.codec.binary.Base32InputStreamTest.testBase32EmptyInputStreamPemChuckSize()	org.apache.commons.codec.binary.Base32InputStreamTest.testBase32EmptyInputStream(int)
org.apache.commons.codec.language.bm.PhoneticEngine.encode(String)	org.apache.commons.codec.language.bm.PhoneticEngine.encode(String,LanguageSet)
org.apache.commons.codec.binary.HexCharTest.testDecodeBadCharacterPos1()	org.apache.commons.codec.binary.Hex.decode(String)
org.apache.commons.codec.binary.HexCharTest.testEncodeDecodeRandom()	org.apache.commons.codec.binary.Hex.encode(String)
org.apache.commons.codec.digest.DigestUtilsTest.testSha384()	org.apache.commons.codec.digest.DigestUtils.sha384Hex(String)
org.apache.commons.codec.language.DoubleMetaphoneTest.assertDoubleMetaphoneAlt(String,String)	org.apache.commons.codec.language.DoubleMetaphoneTest.getDoubleMetaphone()
org.apache.commons.codec.net.QuotedPrintableStringCodecTest.testEncodeStrings()	org.apache.commons.codec.net.QuotedPrintableStringCodec.encode(String)
org.apache.commons.codec.language.DoubleMetaphone.handleJ(String,DoubleMetaphoneResult,int,boolean)	org.apache.commons.codec.language.DoubleMetaphone.contains(String,int,int,String)
org.apache.commons.codec.language.DoubleMetaphone.handleCC(String,DoubleMetaphoneResult,int)	org.apache.commons.codec.language.DoubleMetaphone.contains(String,int,int,String,String,String)
org.apache.commons.codec.net.URLCodecStringTest.testEncodeDecodeNull()	org.apache.commons.codec.net.URLStringCodec.encode(String)
org.apache.commons.codec.language.DoubleMetaphone.doubleMetaphone(String,boolean)	org.apache.commons.codec.language.DoubleMetaphone.handleP(String,DoubleMetaphoneResult,int)
org.apache.commons.codec.language.Caverphone2Test.testCaverphoneRevisitedRandomWords()	org.apache.commons.codec.StringEncoderAbstractTest.checkEncodingVariations(String,String[])
org.apache.commons.codec.binary.Base64Test.testTripletsChunked()	org.apache.commons.codec.binary.Base64.encodeBase64Chunked(byte[])
org.apache.commons.codec.language.MetaphoneTest.testWhy()	org.apache.commons.codec.language.MetaphoneTest.getMetaphone()
org.apache.commons.codec.language.bm.Rule.isMatch(CharSequence)	org.apache.commons.codec.language.bm.Rule.contains(CharSequence,char)
org.apache.commons.codec.net.BCodec.encode(String)	org.apache.commons.codec.net.BCodec.getDefaultCharset()
org.apache.commons.codec.language.RefinedSoundexTest.testGetMappingCodeNonLetter()	org.apache.commons.codec.language.RefinedSoundex.getMappingCode(char)
org.apache.commons.codec.digest.DigestUtilsTest.testSha512()	org.apache.commons.codec.digest.DigestUtils.sha512Hex(InputStream)
org.apache.commons.codec.net.URLCodecStringTest.testEncodeDecodeNull()	org.apache.commons.codec.net.URLStringCodec.decode(String)
org.apache.commons.codec.language.bm.Rule.pattern(String)	org.apache.commons.codec.language.bm.Rule.contains(CharSequence,char)
org.apache.commons.codec.net.BCodec.encode(String)	org.apache.commons.codec.net.BCodec.encode(String,String)
org.apache.commons.codec.binary.Base64Codec13Test.testStaticEncodeChunked()	org.apache.commons.codec.binary.Base64Codec13Test.utf8(String)
org.apache.commons.codec.binary.Hex.encodeHex(byte[],boolean)	org.apache.commons.codec.binary.Hex.encodeHex(byte[],char[])
org.apache.commons.codec.binary.Base32InputStreamTest.testMarkSupported()	org.apache.commons.codec.binary.StringUtils.getBytesUtf8(String)
org.apache.commons.codec.binary.HexByteTest.testHelloWorldUpperCaseHex()	org.apache.commons.codec.binary.Hex.encodeHex(byte[],boolean)
org.apache.commons.codec.net.QCodecTest.testEncodeDecodeBlanks()	org.apache.commons.codec.net.QCodec.setEncodeBlanks(boolean)
org.apache.commons.codec.binary.HexCharTest.testDencodeEmpty()	org.apache.commons.codec.binary.Hex.decode(String)
org.apache.commons.codec.binary.Base64Test.testDecodeWithWhitespace()	org.apache.commons.codec.binary.Base64.encodeBase64(byte[])
org.apache.commons.codec.language.bm.PhoneticEngine.encode(String,LanguageSet)	org.apache.commons.codec.language.bm.PhoneticEngine.encode(String)
org.apache.commons.codec.language.SoundexTest.testUsEnglishStatic()	org.apache.commons.codec.language.Soundex.soundex(String)
org.apache.commons.codec.binary.HexCharTest.charsetSanityCheck(String)	org.apache.commons.codec.binary.HexCharTest.log(String)
org.apache.commons.codec.binary.Base64.encodeBase64String(byte[])	org.apache.commons.codec.binary.Base64.encodeBase64(byte[],boolean)
org.apache.commons.codec.language.DoubleMetaphone.handleW(String,DoubleMetaphoneResult,int)	org.apache.commons.codec.language.DoubleMetaphone.contains(String,int,int,String,String,String,String)
org.apache.commons.codec.language.ColognePhoneticTest.testExamples()	org.apache.commons.codec.StringEncoderAbstractTest.checkEncodings(String[][])
org.apache.commons.codec.binary.Base32InputStreamTest.testBase32InputStreamByteByByte()	org.apache.commons.codec.binary.Base32TestData.randomData(BaseNCodec,int)
org.apache.commons.codec.binary.Base64OutputStreamTest.testBase64OutputStreamByteByByte()	org.apache.commons.codec.binary.StringUtils.getBytesUtf8(String)
org.apache.commons.codec.language.DoubleMetaphoneTest.testEmpty()	org.apache.commons.codec.language.DoubleMetaphone.doubleMetaphone(String)
org.apache.commons.codec.language.SoundexTest.testNewInstance3()	org.apache.commons.codec.language.Soundex.soundex(String)
org.apache.commons.codec.language.ColognePhonetic.CologneBuffer.toString()	org.apache.commons.codec.language.ColognePhonetic.CologneBuffer.copyData(int,int)
org.apache.commons.codec.binary.Base32InputStreamTest.testRead0()	org.apache.commons.codec.binary.BaseNCodecInputStream.read(byte[],int,int)
org.apache.commons.codec.language.ColognePhoneticTest.testAaclan()	org.apache.commons.codec.StringEncoderAbstractTest.checkEncoding(String,String)
org.apache.commons.codec.language.DoubleMetaphone.handleS(String,DoubleMetaphoneResult,int,boolean)	org.apache.commons.codec.language.DoubleMetaphone.DoubleMetaphoneResult.append(char)
org.apache.commons.codec.binary.HexCharCodec.encode(byte[])	org.apache.commons.codec.binary.Hex.encodeHex(byte[])
org.apache.commons.codec.binary.BinaryByteCodecTest.testToByteArrayFromString()	org.apache.commons.codec.binary.BinaryCodec.toByteArray(String)
org.apache.commons.codec.binary.HexByteTest.testCustomCharset(String,String)	org.apache.commons.codec.binary.Hex.encodeHexString(byte[])
org.apache.commons.codec.binary.BinaryByteCodecTest.testToAsciiBytes()	org.apache.commons.codec.binary.BinaryCodec.toAsciiBytes(byte[])
org.apache.commons.codec.binary.Base64Codec13Test.testEncoder()	org.apache.commons.codec.binary.Base64Codec13Test.utf8(String)
org.apache.commons.codec.binary.Base64OutputStreamTest.testCodec98NPE()	org.apache.commons.codec.binary.BaseNCodecOutputStream.close()
org.apache.commons.codec.binary.Base64Test.testByteToStringVariations()	org.apache.commons.codec.binary.Hex.decodeHex(char[])
org.apache.commons.codec.net.QCodecTest.testUnsafeEncodeDecode()	org.apache.commons.codec.net.QCodec.encode(String)
org.apache.commons.codec.language.bm.BeiderMorseEncoderTest.testSetRuleTypeToRulesIllegalArgumentException()	org.apache.commons.codec.language.bm.BeiderMorseEncoder.setRuleType(RuleType)
org.apache.commons.codec.binary.Base64InputStreamTest.testByChunk(byte[],byte[],int,byte[])	org.apache.commons.codec.binary.Base64TestData.streamToBytes(InputStream)
org.apache.commons.codec.digest.DigestUtilsTest.testSha256()	org.apache.commons.codec.digest.DigestUtils.sha256Hex(InputStream)
org.apache.commons.codec.binary.HexByteTest.testHelloWorldUpperCaseHex()	org.apache.commons.codec.binary.StringUtils.getBytesUtf8(String)
org.apache.commons.codec.digest.DigestUtils.sha512Hex(InputStream)	org.apache.commons.codec.digest.DigestUtils.sha512(InputStream)
org.apache.commons.codec.language.DoubleMetaphoneTest.testCCedilla()	org.apache.commons.codec.language.DoubleMetaphoneTest.getDoubleMetaphone()
org.apache.commons.codec.language.DoubleMetaphone.handleCH(String,DoubleMetaphoneResult,int)	org.apache.commons.codec.language.DoubleMetaphone.conditionCH1(String,int)
org.apache.commons.codec.binary.HexCharTest.testCustomCharsetBadNameEncodeByteArray()	org.apache.commons.codec.binary.HexCharCodec.encode(byte[])
org.apache.commons.codec.language.Metaphone.metaphone(String)	org.apache.commons.codec.language.Metaphone.isVowel(StringBuffer,int)
org.apache.commons.codec.net.QuotedPrintableStringCodecTest.testEncodeNull()	org.apache.commons.codec.net.QuotedPrintableCodec.encode(byte[])
org.apache.commons.codec.language.MetaphoneTest.testSetMaxLengthWithTruncation()	org.apache.commons.codec.language.MetaphoneTest.getMetaphone()
org.apache.commons.codec.binary.Base32TestData.streamToBytes(InputStream,byte[])	org.apache.commons.codec.binary.Base32TestData.fill(byte[],int,InputStream)
org.apache.commons.codec.binary.Base64Test.testStringToByteVariations()	org.apache.commons.codec.binary.Hex.decodeHex(char[])
org.apache.commons.codec.binary.Base64Test.testEncodeDecodeSmall()	org.apache.commons.codec.binary.Base64Test.toString(byte[])
org.apache.commons.codec.binary.HexByteTest.testEncodeDecodeRandom()	org.apache.commons.codec.binary.Hex.decode(char[])
org.apache.commons.codec.binary.Base64OutputStreamTest.testBase64EmptyOutputStream(int)	org.apache.commons.codec.binary.Base64OutputStreamTest.testByChunk(byte[],byte[],int,byte[])
org.apache.commons.codec.language.DoubleMetaphone.handleGH(String,DoubleMetaphoneResult,int)	org.apache.commons.codec.language.DoubleMetaphone.isVowel(char)
org.apache.commons.codec.binary.Base64Codec13Test.testStaticDecode()	org.apache.commons.codec.binary.Base64Codec13Test.utf8(String)
org.apache.commons.codec.net.BCodecTest.testUTF8RoundTrip()	org.apache.commons.codec.net.BCodec.decode(String)
org.apache.commons.codec.binary.Base32InputStreamTest.testByChunk(byte[],byte[],int,byte[])	org.apache.commons.codec.binary.Base32TestData.streamToBytes(InputStream)
org.apache.commons.codec.digest.DigestUtils.sha256Hex(byte[])	org.apache.commons.codec.binary.Hex.encodeHexString(byte[])
org.apache.commons.codec.binary.StringUtilsTest.testNewStringUtf16Le()	org.apache.commons.codec.binary.StringUtils.newStringUtf16Le(byte[])
org.apache.commons.codec.net.QuotedPrintableBinaryCodecTest.testEncodeDecodeNull()	org.apache.commons.codec.Encoder.encode(I)
org.apache.commons.codec.language.DoubleMetaphone.doubleMetaphone(String,boolean)	org.apache.commons.codec.language.DoubleMetaphone.DoubleMetaphoneResult.getPrimary()
org.apache.commons.codec.net.URLStringCodec.encode(String,String)	org.apache.commons.codec.net.URLCodec.encode(byte[])
org.apache.commons.codec.binary.BinaryByteCodecTest.testFromAsciiCharArray()	org.apache.commons.codec.binary.BinaryCodec.fromAscii(char[])
org.apache.commons.codec.digest.DigestUtilsTest.testMD5Length()	org.apache.commons.codec.digest.DigestUtilsTest.getBytesUtf8(String)
org.apache.commons.codec.digest.DigestUtils.md5(byte[])	org.apache.commons.codec.digest.DigestUtils.getMd5Digest()
org.apache.commons.codec.language.bm.PhoneticEngine.PhonemeBuilder.apply(PhonemeExpr)	org.apache.commons.codec.language.bm.Languages.LanguageSet.isEmpty()
org.apache.commons.codec.StringEncoderAbstractTest.checkEncoding(String,String)	org.apache.commons.codec.StringEncoder.encode(String)
org.apache.commons.codec.binary.StringUtils.getBytesUsAscii(String)	org.apache.commons.codec.binary.StringUtils.getBytesUnchecked(String,String)
org.apache.commons.codec.language.DoubleMetaphone.conditionCH1(String,int)	org.apache.commons.codec.language.DoubleMetaphone.contains(String,int,int,String,String,String)
org.apache.commons.codec.language.SoundexTest.testEncodeBatch2()	org.apache.commons.codec.language.SoundexTest.getSoundexEncoder()
org.apache.commons.codec.binary.Base64InputStreamTest.testInputStreamReader()	org.apache.commons.codec.binary.StringUtils.getBytesUtf8(String)
org.apache.commons.codec.binary.BinaryByteCodecTest.assertDecodeObject(byte[],String)	org.apache.commons.codec.binary.BinaryCodec.decode(String)
org.apache.commons.codec.binary.BinaryCharCodecTest.testEncodeByteArray()	org.apache.commons.codec.binary.BinaryCharCodec.encode(byte[])
org.apache.commons.codec.binary.Base64Test.testNonBase64Test()	org.apache.commons.codec.binary.Base64.isBase64(byte[])
org.apache.commons.codec.digest.DigestUtils.getShaDigest()	org.apache.commons.codec.digest.DigestUtils.getDigest(String)
org.apache.commons.codec.language.DoubleMetaphoneTest.testIsDoubleMetaphoneEqualWithMATCHES()	org.apache.commons.codec.language.DoubleMetaphone.isDoubleMetaphoneEqual(String,String,boolean)
org.apache.commons.codec.language.SoundexTest.testMsSqlServer1()	org.apache.commons.codec.language.SoundexTest.getSoundexEncoder()
org.apache.commons.codec.binary.HexByteTest.testHelloWorldLowerCaseHex()	org.apache.commons.codec.binary.Hex.encodeHex(byte[])
org.apache.commons.codec.language.DoubleMetaphone.doubleMetaphone(String)	org.apache.commons.codec.language.DoubleMetaphone.doubleMetaphone(String,boolean)
org.apache.commons.codec.binary.Hex.decode(byte[])	org.apache.commons.codec.binary.Hex.getCharsetName()
org.apache.commons.codec.language.Caverphone1Test.testCaverphoneRevisitedCommonCodeAT1111()	org.apache.commons.codec.StringEncoderAbstractTest.checkEncodingVariations(String,String[])
org.apache.commons.codec.net.RFC1522CodecTest.testNullInput()	org.apache.commons.codec.net.RFC1522Codec.decodeText(String)
org.apache.commons.codec.digest.DigestUtils.sha384(String)	org.apache.commons.codec.digest.DigestUtils.sha384(byte[])
org.apache.commons.codec.net.QuotedPrintableBinaryCodecTest.testDecodeWithNullArray()	org.apache.commons.codec.net.QuotedPrintableCodec.decodeQuotedPrintable(byte[])
org.apache.commons.codec.binary.Base64InputStreamTest.testRead0()	org.apache.commons.codec.binary.BaseNCodecInputStream.read(byte[],int,int)
org.apache.commons.codec.language.DoubleMetaphoneTest.testEmpty()	org.apache.commons.codec.language.DoubleMetaphoneTest.getDoubleMetaphone()
org.apache.commons.codec.language.bm.PhoneticEngine.PhonemeBuilder.apply(PhonemeExpr)	org.apache.commons.codec.language.bm.Rule.PhonemeExpr.getPhonemes()
org.apache.commons.codec.net.QuotedPrintableStringCodecTest.testUTF8RoundTrip()	org.apache.commons.codec.net.QuotedPrintableStringCodec.encode(String,String)
org.apache.commons.codec.language.DoubleMetaphone.doubleMetaphone(String,boolean)	org.apache.commons.codec.language.DoubleMetaphone.isSlavoGermanic(String)
org.apache.commons.codec.language.DoubleMetaphone.doubleMetaphone(String,boolean)	org.apache.commons.codec.language.DoubleMetaphone.handleAEIOUY(DoubleMetaphoneResult,int)
org.apache.commons.codec.binary.Base32InputStreamTest.testBase32InputStreamByteByByte()	org.apache.commons.codec.binary.Base32InputStreamTest.testByteByByte(byte[],byte[],int,byte[])
org.apache.commons.codec.language.ColognePhoneticTest.testVariationsMella()	org.apache.commons.codec.StringEncoderAbstractTest.checkEncodingVariations(String,String[])
org.apache.commons.codec.binary.Base64Test.testEncodeDecode(String)	org.apache.commons.codec.binary.Base64.encodeBase64String(byte[])
org.apache.commons.codec.binary.Base64Test.testDecodeWithWhitespace()	org.apache.commons.codec.binary.Base64.decodeBase64(byte[])
org.apache.commons.codec.language.Caverphone2Test.testCaverphoneRevisitedExamples()	org.apache.commons.codec.StringEncoderAbstractTest.checkEncodings(String[][])
org.apache.commons.codec.binary.BinaryCodec.decode(byte[])	org.apache.commons.codec.binary.BinaryCodec.fromAscii(byte[])
org.apache.commons.codec.language.DoubleMetaphone.handleT(String,DoubleMetaphoneResult,int)	org.apache.commons.codec.language.DoubleMetaphone.contains(String,int,int,String,String)
org.apache.commons.codec.language.bm.PhoneticEngine.applyFinalRules(PhonemeBuilder,List<Rule>)	org.apache.commons.codec.language.bm.PhoneticEngine.RulesApplication.getPhonemeBuilder()
org.apache.commons.codec.language.bm.Rule.parsePhonemeExpr(String)	org.apache.commons.codec.language.bm.Rule.parsePhoneme(String)
org.apache.commons.codec.binary.BinaryByteCodecTest.testDecodeByteArray()	org.apache.commons.codec.binary.BinaryCodec.decode(byte[])
org.apache.commons.codec.language.DoubleMetaphoneTest.getDoubleMetaphone()	org.apache.commons.codec.StringEncoderAbstractTest.getStringEncoder()
org.apache.commons.codec.binary.Base32TestData.streamToBytes(InputStream,byte[])	org.apache.commons.codec.binary.Base32TestData.resizeArray(byte[])
org.apache.commons.codec.net.QuotedPrintableBinaryCodecTest.testEncodeDecodeNull()	org.apache.commons.codec.Decoder.decode(I)
org.apache.commons.codec.digest.DigestUtils.getBytesUtf8(String)	org.apache.commons.codec.binary.StringUtils.getBytesUtf8(String)
org.apache.commons.codec.binary.BinaryCharCodecTest.assertDecodeObject(byte[],String)	org.apache.commons.codec.binary.BinaryCodec.decode(String)
org.apache.commons.codec.net.QuotedPrintableStringCodec.decode(String)	org.apache.commons.codec.net.QuotedPrintableCodec.getDefaultCharset()
org.apache.commons.codec.language.DoubleMetaphone.handleX(String,DoubleMetaphoneResult,int)	org.apache.commons.codec.language.DoubleMetaphone.DoubleMetaphoneResult.append(String)
org.apache.commons.codec.language.bm.BeiderMorseEncoderTest.testSpeedCheck()	org.apache.commons.codec.language.bm.BeiderMorseEncoderTest.createGenericApproxEncoder()
org.apache.commons.codec.net.URLStringCodec.decode(String)	org.apache.commons.codec.net.URLStringCodec.getDefaultCharset()
org.apache.commons.codec.language.RefinedSoundex.soundex(String)	org.apache.commons.codec.language.RefinedSoundex.getMappingCode(char)
org.apache.commons.codec.net.URLCodecStringTest.testInvalidEncoding()	org.apache.commons.codec.net.URLStringCodec.decode(String)
org.apache.commons.codec.digest.DigestUtilsTest.testMd5Hex()	org.apache.commons.codec.digest.DigestUtils.md5Hex(InputStream)
org.apache.commons.codec.language.SoundexTest.testEncodeBatch3()	org.apache.commons.codec.language.Soundex.encode(String)
org.apache.commons.codec.digest.DigestUtilsTest.testSha512()	org.apache.commons.codec.digest.DigestUtils.sha512Hex(String)
org.apache.commons.codec.language.MetaphoneTest.testIsMetaphoneEqual2()	org.apache.commons.codec.language.MetaphoneTest.assertMetaphoneEqual(String[][])
org.apache.commons.codec.binary.Base64Test.testEncodeDecodeSmall()	org.apache.commons.codec.binary.Base64.isBase64(byte[])
org.apache.commons.codec.language.DoubleMetaphone.handleW(String,DoubleMetaphoneResult,int)	org.apache.commons.codec.language.DoubleMetaphone.DoubleMetaphoneResult.append(char)
org.apache.commons.codec.language.DoubleMetaphone.conditionM0(String,int)	org.apache.commons.codec.language.DoubleMetaphone.charAt(String,int)
org.apache.commons.codec.binary.Base32InputStreamTest.testMarkSupported()	org.apache.commons.codec.binary.BaseNCodecInputStream.markSupported()
org.apache.commons.codec.binary.Base64.decodeBase64(byte[])	org.apache.commons.codec.binary.BaseNCodec.decode(byte[])
org.apache.commons.codec.language.DoubleMetaphoneTest.doubleMetaphoneNotEqualTest(boolean)	org.apache.commons.codec.language.DoubleMetaphone.isDoubleMetaphoneEqual(String,String)
org.apache.commons.codec.net.QuotedPrintableStringCodec.encode(String)	org.apache.commons.codec.net.QuotedPrintableStringCodec.encode(String,String)
org.apache.commons.codec.language.DoubleMetaphone.DoubleMetaphoneResult.append(String)	org.apache.commons.codec.language.DoubleMetaphone.DoubleMetaphoneResult.appendPrimary(String)
org.apache.commons.codec.binary.Base32Test.testSingleCharEncoding()	org.apache.commons.codec.binary.Base32.encode(byte[],int,int)
org.apache.commons.codec.binary.Base64Test.testByteToStringVariations()	org.apache.commons.codec.binary.Base64.encodeBase64String(byte[])
org.apache.commons.codec.binary.HexCharTest.testHelloWorldUpperCaseHex()	org.apache.commons.codec.binary.Hex.encodeHex(byte[],boolean)
org.apache.commons.codec.language.MetaphoneTest.testTranslateToJOfDGEOrDGIOrDGY()	org.apache.commons.codec.language.Metaphone.metaphone(String)
org.apache.commons.codec.language.DoubleMetaphone.handleC(String,DoubleMetaphoneResult,int)	org.apache.commons.codec.language.DoubleMetaphone.handleCC(String,DoubleMetaphoneResult,int)
org.apache.commons.codec.binary.BaseNCodec.encode(byte[])	org.apache.commons.codec.binary.BaseNCodec.encode(byte[],int,int)
org.apache.commons.codec.language.bm.Rule.isMatch(CharSequence)	org.apache.commons.codec.language.bm.Rule.contains(CharSequence,char)
org.apache.commons.codec.binary.Base32Test.testRandomBytesChunked()	org.apache.commons.codec.binary.Base32TestData.randomData(BaseNCodec,int)
org.apache.commons.codec.language.bm.BeiderMorseEncoderTest.testInvalidLangIllegalArgumentException()	org.apache.commons.codec.language.bm.Rule.getInstance(NameType,RuleType,String)
org.apache.commons.codec.binary.Base64.encodeBase64URLSafe(byte[])	org.apache.commons.codec.binary.Base64.encodeBase64(byte[],boolean,boolean)
org.apache.commons.codec.language.ColognePhoneticTest.testAabjoe()	org.apache.commons.codec.StringEncoderAbstractTest.checkEncoding(String,String)
org.apache.commons.codec.binary.Base64Test.testChunkedEncodeMultipleOf76()	org.apache.commons.codec.binary.StringUtils.getBytesUtf8(String)
org.apache.commons.codec.language.bm.BeiderMorseEncoder.setNameType(NameType)	org.apache.commons.codec.language.bm.PhoneticEngine.isConcat()
org.apache.commons.codec.binary.BaseNCodec.isInAlphabet(String)	org.apache.commons.codec.binary.BaseNCodec.isInAlphabet(byte[],boolean)
org.apache.commons.codec.language.bm.Rule.getInstance(NameType,RuleType,String)	org.apache.commons.codec.language.bm.NameType.getName()
org.apache.commons.codec.binary.Base64Test.testUUID()	org.apache.commons.codec.binary.StringUtils.getBytesUtf8(String)
org.apache.commons.codec.language.DoubleMetaphoneTest.testNTilde()	org.apache.commons.codec.language.DoubleMetaphone.isDoubleMetaphoneEqual(String,String)
org.apache.commons.codec.language.bm.BeiderMorseEncoderTest.testSetConcat()	org.apache.commons.codec.language.bm.BeiderMorseEncoder.setConcat(boolean)
org.apache.commons.codec.digest.DigestUtils.sha(InputStream)	org.apache.commons.codec.digest.DigestUtils.digest(MessageDigest,InputStream)
org.apache.commons.codec.binary.Base64Test.testCodeInteger4()	org.apache.commons.codec.binary.Base64.decodeInteger(byte[])
org.apache.commons.codec.language.ColognePhoneticTest.testVariationsMeyer()	org.apache.commons.codec.StringEncoderAbstractTest.checkEncodingVariations(String,String[])
org.apache.commons.codec.net.BCodecTest.testEncodeDecodeNull()	org.apache.commons.codec.net.BCodec.encode(String)
org.apache.commons.codec.StringEncoderComparator.compare(String,String)	org.apache.commons.codec.StringEncoder.encode(String)
org.apache.commons.codec.language.DoubleMetaphone.conditionC0(String,int)	org.apache.commons.codec.language.DoubleMetaphone.contains(String,int,int,String,String)
org.apache.commons.codec.language.bm.BeiderMorseEncoderTest.testAllChars()	org.apache.commons.codec.language.bm.BeiderMorseEncoderTest.createGenericApproxEncoder()
org.apache.commons.codec.binary.StringUtilsTest.testGetBytesUtf16Be()	org.apache.commons.codec.binary.StringUtilsTest.testGetBytesUnchecked(String)
org.apache.commons.codec.net.RFC1522Codec.decodeText(String)	org.apache.commons.codec.net.RFC1522Codec.getEncoding()
org.apache.commons.codec.language.bm.RuleTest.testPhonemeComparedToSelfIsZero()	org.apache.commons.codec.language.bm.RuleTest.makePhonemes()
org.apache.commons.codec.net.URLCodecBinaryTest.testDecodeWithNullArray()	org.apache.commons.codec.net.URLCodec.decodeUrl(byte[])
org.apache.commons.codec.language.RefinedSoundexTest.testDifference()	org.apache.commons.codec.language.RefinedSoundexTest.getRefinedSoundex()
org.apache.commons.codec.binary.BaseNCodecOutputStream.flush(boolean)	org.apache.commons.codec.binary.BaseNCodec.available()
org.apache.commons.codec.language.ColognePhonetic.CologneInputBuffer.removeNext()	org.apache.commons.codec.language.ColognePhonetic.CologneInputBuffer.getNextChar()
org.apache.commons.codec.net.URLCodecStringTest.testUTF8RoundTrip()	org.apache.commons.codec.net.URLCodecStringTest.validateState(URLStringCodec)
org.apache.commons.codec.language.DoubleMetaphone.DoubleMetaphoneResult.append(char,char)	org.apache.commons.codec.language.DoubleMetaphone.DoubleMetaphoneResult.appendPrimary(char)
org.apache.commons.codec.net.BCodecTest.testEncodeDecodeNull()	org.apache.commons.codec.net.BCodec.decode(String)
org.apache.commons.codec.binary.BaseNCodecOutputStream.write(byte[],int,int)	org.apache.commons.codec.binary.BaseNCodecOutputStream.flush(boolean)
org.apache.commons.codec.net.URLCodec.encode(byte[])	org.apache.commons.codec.net.URLCodec.encodeUrl(BitSet,byte[])
org.apache.commons.codec.net.QCodecTest.testNullInput()	org.apache.commons.codec.net.QCodec.doDecoding(byte[])
org.apache.commons.codec.language.Metaphone.metaphone(String)	org.apache.commons.codec.language.Metaphone.regionMatch(StringBuffer,int,String)
org.apache.commons.codec.binary.HexByteTest.testCustomCharset(String,String)	org.apache.commons.codec.binary.Hex.getCharsetName()
org.apache.commons.codec.net.QuotedPrintableStringCodecTest.testUTF8RoundTrip()	org.apache.commons.codec.net.QuotedPrintableStringCodecTest.constructString(int[])
org.apache.commons.codec.binary.HexCharTest.testEncodeDecodeRandom()	org.apache.commons.codec.binary.StringUtils.getBytesUtf8(String)
org.apache.commons.codec.net.RFC1522Codec.encodeText(String,String)	org.apache.commons.codec.net.RFC1522Codec.getEncoding()
org.apache.commons.codec.language.DoubleMetaphone.handleZ(String,DoubleMetaphoneResult,int,boolean)	org.apache.commons.codec.language.DoubleMetaphone.DoubleMetaphoneResult.append(char)
org.apache.commons.codec.language.DoubleMetaphone.DoubleMetaphoneResult.append(char,char)	org.apache.commons.codec.language.DoubleMetaphone.DoubleMetaphoneResult.appendAlternate(char)
org.apache.commons.codec.binary.BinaryByteCodecTest.testEncodeByteArray()	org.apache.commons.codec.binary.BinaryByteCodec.encode(byte[])
org.apache.commons.codec.language.ColognePhonetic.CologneInputBuffer.addLeft(char)	org.apache.commons.codec.language.ColognePhonetic.CologneInputBuffer.getNextPos()
org.apache.commons.codec.net.RFC1522CodecTest.testDecodeInvalid()	org.apache.commons.codec.net.RFC1522CodecTest.assertExpectedDecoderException(String)
org.apache.commons.codec.binary.HexCharTest.checkDecodeHexOddCharacters(char[])	org.apache.commons.codec.binary.Hex.decodeHex(char[])
org.apache.commons.codec.net.URLStringCodec.encode(String,String)	org.apache.commons.codec.binary.StringUtils.newStringUsAscii(byte[])
org.apache.commons.codec.language.SoundexTest.testEncodeIgnoreTrimmable()	org.apache.commons.codec.language.SoundexTest.getSoundexEncoder()
org.apache.commons.codec.net.QuotedPrintableStringCodecTest.testEncodeStrings()	org.apache.commons.codec.net.QuotedPrintableCodec.encode(byte[])
org.apache.commons.codec.language.MetaphoneTest.testWhy()	org.apache.commons.codec.language.Metaphone.metaphone(String)
org.apache.commons.codec.binary.StringUtils.newStringUtf8(byte[])	org.apache.commons.codec.binary.StringUtils.newString(byte[],String)
org.apache.commons.codec.binary.StringUtilsTest.testNewStringUsAscii()	org.apache.commons.codec.binary.StringUtils.newStringUsAscii(byte[])
org.apache.commons.codec.binary.Base64InputStreamTest.testReadOutOfBounds()	org.apache.commons.codec.binary.StringUtils.getBytesUtf8(String)
org.apache.commons.codec.binary.StringUtils.newStringUtf16Le(byte[])	org.apache.commons.codec.binary.StringUtils.newString(byte[],String)
org.apache.commons.codec.binary.HexByteTest.testEncodeDecodeRandom()	org.apache.commons.codec.binary.StringUtils.getBytesUtf8(String)
org.apache.commons.codec.net.QCodecTest.testEncodeObjects()	org.apache.commons.codec.net.QCodec.encode(String)
org.apache.commons.codec.binary.Base64.decodeInteger(byte[])	org.apache.commons.codec.binary.Base64.decodeBase64(byte[])
org.apache.commons.codec.net.QuotedPrintableStringCodecTest.testDecodeStrings()	org.apache.commons.codec.net.QuotedPrintableCodec.decode(byte[])
org.apache.commons.codec.language.bm.Rule.patternAndContextMatches(CharSequence,int)	org.apache.commons.codec.language.bm.Rule.RPattern.isMatch(CharSequence)
org.apache.commons.codec.language.DoubleMetaphone.handleSC(String,DoubleMetaphoneResult,int)	org.apache.commons.codec.language.DoubleMetaphone.contains(String,int,int,String,String,String,String,String,String)
org.apache.commons.codec.language.MetaphoneTest.testIsMetaphoneEqualWhite()	org.apache.commons.codec.language.MetaphoneTest.assertIsMetaphoneEqual(String,String[])
org.apache.commons.codec.net.URLCodecBinaryTest.testEncodeDecodeNull()	org.apache.commons.codec.Decoder.decode(I)
org.apache.commons.codec.language.RefinedSoundexTest.testDifference()	org.apache.commons.codec.language.RefinedSoundex.difference(String,String)
org.apache.commons.codec.language.DoubleMetaphone.handleS(String,DoubleMetaphoneResult,int,boolean)	org.apache.commons.codec.language.DoubleMetaphone.handleSC(String,DoubleMetaphoneResult,int)
org.apache.commons.codec.net.BCodecTest.testEncodeObjects()	org.apache.commons.codec.net.BCodec.encode(String)
org.apache.commons.codec.binary.Base64OutputStreamTest.testBase64EmptyOutputStreamPemChunkSize()	org.apache.commons.codec.binary.Base64OutputStreamTest.testBase64EmptyOutputStream(int)
org.apache.commons.codec.language.DoubleMetaphone2Test.checkDoubleMetaphone(int,boolean)	org.apache.commons.codec.language.DoubleMetaphone.doubleMetaphone(String,boolean)
org.apache.commons.codec.binary.BaseNCodec.encodeAsString(byte[])	org.apache.commons.codec.binary.StringUtils.newStringUtf8(byte[])
org.apache.commons.codec.digest.DigestUtils.md5(InputStream)	org.apache.commons.codec.digest.DigestUtils.getMd5Digest()
org.apache.commons.codec.binary.Base64Test.testCodec68()	org.apache.commons.codec.binary.Base64.decodeBase64(byte[])
org.apache.commons.codec.language.bm.BeiderMorseEncoderTest.testSpeedCheck2()	org.apache.commons.codec.language.bm.BeiderMorseEncoder.encode(String)
org.apache.commons.codec.language.DoubleMetaphone.doubleMetaphone(String,boolean)	org.apache.commons.codec.language.DoubleMetaphone.handleG(String,DoubleMetaphoneResult,int,boolean)
org.apache.commons.codec.binary.Base32.encode(byte[],int,int)	org.apache.commons.codec.binary.BaseNCodec.ensureBufferSize(int)
org.apache.commons.codec.net.QuotedPrintableStringCodecTest.testEncodeStringWithNull()	org.apache.commons.codec.net.QuotedPrintableStringCodec.encode(String,String)
org.apache.commons.codec.binary.Base64Test.testBase64()	org.apache.commons.codec.binary.BaseNCodec.encode(byte[])
org.apache.commons.codec.net.QuotedPrintableCodec.decodeQuotedPrintable(byte[])	org.apache.commons.codec.net.Utils.digit16(byte)
org.apache.commons.codec.binary.StringUtilsTest.testNewStringUtf16()	org.apache.commons.codec.binary.StringUtils.newStringUtf16(byte[])
org.apache.commons.codec.language.DoubleMetaphone.handleC(String,DoubleMetaphoneResult,int)	org.apache.commons.codec.language.DoubleMetaphone.contains(String,int,int,String)
org.apache.commons.codec.binary.Base32OutputStreamTest.testBase32EmptyOutputStream(int)	org.apache.commons.codec.binary.Base32OutputStreamTest.testByteByByte(byte[],byte[],int,byte[])
org.apache.commons.codec.binary.Base64Test.testIsArrayByteBase64()	org.apache.commons.codec.binary.Base64.isBase64(byte[])
org.apache.commons.codec.binary.Base32TestData.streamToBytes(InputStream)	org.apache.commons.codec.binary.Base32TestData.streamToBytes(InputStream,byte[])
org.apache.commons.codec.binary.BaseNCodec.resizeBuffer()	org.apache.commons.codec.binary.BaseNCodec.getDefaultBufferSize()
org.apache.commons.codec.binary.Base64Codec13Test.testBinaryDecoder()	org.apache.commons.codec.binary.Base64Codec13Test.utf8(String)
org.apache.commons.codec.language.SoundexTest.testBadCharacters()	org.apache.commons.codec.language.Soundex.encode(String)
org.apache.commons.codec.binary.Base32OutputStreamTest.testWriteOutOfBounds()	org.apache.commons.codec.binary.BaseNCodecOutputStream.write(byte[],int,int)
org.apache.commons.codec.language.bm.BeiderMorseEncoderTest.testInvalidLangIllegalStateException()	org.apache.commons.codec.language.bm.Lang.loadFromResource(String,Languages)
org.apache.commons.codec.net.BCodecTest.testUTF8RoundTrip()	org.apache.commons.codec.net.BCodecTest.constructString(int[])
org.apache.commons.codec.binary.Base64InputStreamTest.testMarkSupported()	org.apache.commons.codec.binary.StringUtils.getBytesUtf8(String)
org.apache.commons.codec.language.SoundexTest.testEncodeBasic()	org.apache.commons.codec.language.Soundex.encode(String)
org.apache.commons.codec.net.QCodecTest.testLetUsMakeCloverHappy()	org.apache.commons.codec.net.QCodec.setEncodeBlanks(boolean)
org.apache.commons.codec.net.URLCodecStringTest.testSafeCharEncodeDecode()	org.apache.commons.codec.net.URLStringCodec.decode(String)
org.apache.commons.codec.language.bm.Lang.guessLanguages(String)	org.apache.commons.codec.language.bm.Languages.LanguageSet.from(Set<String>)
org.apache.commons.codec.binary.BinaryByteCodecTest.assertDecodeObject(byte[],String)	org.apache.commons.codec.binary.BinaryCodec.decode(byte[])
org.apache.commons.codec.binary.HexCharTest.testHelloWorldLowerCaseHex()	org.apache.commons.codec.binary.StringUtils.getBytesUtf8(String)
org.apache.commons.codec.binary.HexCharTest.testCustomCharset(String,String)	org.apache.commons.codec.binary.Hex.decode(char[])
org.apache.commons.codec.digest.DigestUtils.sha512(String)	org.apache.commons.codec.digest.DigestUtils.getBytesUtf8(String)
org.apache.commons.codec.StringEncoderAbstractTest.checkEncodings(String[][])	org.apache.commons.codec.StringEncoderAbstractTest.checkEncoding(String,String)
org.apache.commons.codec.binary.Base64.encodeBase64(byte[])	org.apache.commons.codec.binary.Base64.encodeBase64(byte[],boolean)
org.apache.commons.codec.language.bm.BeiderMorseEncoder.getRuleType()	org.apache.commons.codec.language.bm.PhoneticEngine.getRuleType()
org.apache.commons.codec.language.DoubleMetaphone.handleSC(String,DoubleMetaphoneResult,int)	org.apache.commons.codec.language.DoubleMetaphone.charAt(String,int)
org.apache.commons.codec.digest.DigestUtils.getSha512Digest()	org.apache.commons.codec.digest.DigestUtils.getDigest(String)
org.apache.commons.codec.language.DoubleMetaphone.handleSC(String,DoubleMetaphoneResult,int)	org.apache.commons.codec.language.DoubleMetaphone.contains(String,int,int,String,String,String)
org.apache.commons.codec.language.bm.BeiderMorseEncoder.isConcat()	org.apache.commons.codec.language.bm.PhoneticEngine.isConcat()
org.apache.commons.codec.binary.HexByteTest.testDecodeHexOddCharacters5()	org.apache.commons.codec.binary.HexByteTest.checkDecodeHexOddCharacters(char[])
org.apache.commons.codec.digest.DigestUtils.sha256(byte[])	org.apache.commons.codec.digest.DigestUtils.getSha256Digest()
org.apache.commons.codec.language.DoubleMetaphone.handleG(String,DoubleMetaphoneResult,int,boolean)	org.apache.commons.codec.language.DoubleMetaphone.contains(String,int,int,String)
org.apache.commons.codec.language.Caverphone2Test.testSpecificationExamples()	org.apache.commons.codec.StringEncoderAbstractTest.checkEncodings(String[][])
org.apache.commons.codec.language.DoubleMetaphone.handleAEIOUY(DoubleMetaphoneResult,int)	org.apache.commons.codec.language.DoubleMetaphone.DoubleMetaphoneResult.append(char)
org.apache.commons.codec.binary.Base64OutputStreamTest.testBase64OutputStreamByteByByte()	org.apache.commons.codec.binary.Base64TestData.randomData(int,boolean)
org.apache.commons.codec.language.bm.BeiderMorseEncoderTest.testLongestEnglishSurname()	org.apache.commons.codec.language.bm.BeiderMorseEncoder.encode(String)
org.apache.commons.codec.language.MetaphoneTest.testIsMetaphoneEqualXalan()	org.apache.commons.codec.language.MetaphoneTest.assertIsMetaphoneEqual(String,String[])
org.apache.commons.codec.binary.Base64Test.testStringToByteVariations()	org.apache.commons.codec.binary.BaseNCodec.decode(String)
org.apache.commons.codec.binary.Base64Test.testEncodeOverMaxSize()	org.apache.commons.codec.binary.Base64Test.testEncodeOverMaxSize(int)
org.apache.commons.codec.net.URLCodecStringTest.testInvalidEncoding()	org.apache.commons.codec.net.URLCodecStringTest.validateState(URLStringCodec)
org.apache.commons.codec.net.URLCodecBinaryTest.testDecodeInvalidContent()	org.apache.commons.codec.net.URLCodec.decode(byte[])
org.apache.commons.codec.binary.Base64Test.testBase64()	org.apache.commons.codec.binary.Base64.encodeBase64(byte[])
org.apache.commons.codec.language.DoubleMetaphone.handleJ(String,DoubleMetaphoneResult,int,boolean)	org.apache.commons.codec.language.DoubleMetaphone.DoubleMetaphoneResult.append(char,char)
org.apache.commons.codec.net.QCodecTest.testNullInput()	org.apache.commons.codec.net.QCodec.doEncoding(byte[])
org.apache.commons.codec.language.DoubleMetaphone.doubleMetaphone(String,boolean)	org.apache.commons.codec.language.DoubleMetaphone.handleD(String,DoubleMetaphoneResult,int)
org.apache.commons.codec.language.DoubleMetaphone.DoubleMetaphoneResult.append(char)	org.apache.commons.codec.language.DoubleMetaphone.DoubleMetaphoneResult.appendAlternate(char)
org.apache.commons.codec.digest.DigestUtilsTest.getBytesUtf8(String)	org.apache.commons.codec.binary.StringUtils.getBytesUtf8(String)
org.apache.commons.codec.binary.BaseNCodecTest.testIsInAlphabetString()	org.apache.commons.codec.binary.BaseNCodec.isInAlphabet(String)
org.apache.commons.codec.language.SoundexTest.testNewInstance()	org.apache.commons.codec.language.Soundex.soundex(String)
org.apache.commons.codec.net.QuotedPrintableStringCodecTest.testEncodeUrlWithNullBitSet()	org.apache.commons.codec.net.QuotedPrintableStringCodec.decode(String)
org.apache.commons.codec.language.bm.Rule.parsePhoneme(String)	org.apache.commons.codec.language.bm.Languages.LanguageSet.from(Set<String>)
org.apache.commons.codec.binary.HexCharTest.testCustomCharsetBadNameDecodeObject()	org.apache.commons.codec.binary.Hex.decode(byte[])
org.apache.commons.codec.binary.BaseNCodecTest.testIsInAlphabetByteArrayBoolean()	org.apache.commons.codec.binary.BaseNCodec.isInAlphabet(byte[],boolean)
org.apache.commons.codec.language.Soundex.soundex(String)	org.apache.commons.codec.language.SoundexUtils.clean(String)
org.apache.commons.codec.binary.HexCharTest.testCustomCharset(String,String)	org.apache.commons.codec.binary.Hex.getCharsetName()
org.apache.commons.codec.binary.Base64Test.testByteToStringVariations()	org.apache.commons.codec.binary.BaseNCodec.encodeToString(byte[])
org.apache.commons.codec.binary.HexByteTest.testDecodeStringOddCharacters()	org.apache.commons.codec.binary.Hex.decode(String)
org.apache.commons.codec.net.QuotedPrintableCodec.encodeQuotedPrintable(BitSet,byte[])	org.apache.commons.codec.net.QuotedPrintableCodec.encodeQuotedPrintable(int,ByteArrayOutputStream)
org.apache.commons.codec.binary.BinaryByteCodecTest.testFromAsciiByteArray()	org.apache.commons.codec.binary.BinaryCodec.fromAscii(byte[])
org.apache.commons.codec.language.DoubleMetaphone.handleC(String,DoubleMetaphoneResult,int)	org.apache.commons.codec.language.DoubleMetaphone.conditionC0(String,int)
org.apache.commons.codec.language.DoubleMetaphone.contains(String,int,int,String,String,String,String,String,String)	org.apache.commons.codec.language.DoubleMetaphone.contains(String,int,int,String[])
org.apache.commons.codec.language.MetaphoneTest.testMetaphone()	org.apache.commons.codec.language.Metaphone.metaphone(String)
org.apache.commons.codec.language.SoundexTest.testEncodeBatch4()	org.apache.commons.codec.language.SoundexTest.getSoundexEncoder()
org.apache.commons.codec.language.bm.BeiderMorseEncoderTest.testEncodeGna()	org.apache.commons.codec.language.bm.BeiderMorseEncoder.encode(String)
org.apache.commons.codec.net.URLCodecBinaryTest.testEncodeDecodeNull()	org.apache.commons.codec.net.URLCodecBinaryTest.validateState(URLBinaryCodec)
org.apache.commons.codec.binary.Base64Test.testConstructor_Int_ByteArray_Boolean()	org.apache.commons.codec.binary.StringUtils.newStringUtf8(byte[])
org.apache.commons.codec.binary.HexByteTest.testDecodeBadCharacterPos0()	org.apache.commons.codec.binary.Hex.decode(String)
org.apache.commons.codec.language.DoubleMetaphone.handleCC(String,DoubleMetaphoneResult,int)	org.apache.commons.codec.language.DoubleMetaphone.contains(String,int,int,String)
org.apache.commons.codec.language.DoubleMetaphone.handleD(String,DoubleMetaphoneResult,int)	org.apache.commons.codec.language.DoubleMetaphone.contains(String,int,int,String,String,String)
org.apache.commons.codec.binary.HexCharTest.testEncodeZeroes()	org.apache.commons.codec.binary.Hex.encodeHex(byte[])
org.apache.commons.codec.language.MetaphoneTest.testDiscardOfSilentHAfterG()	org.apache.commons.codec.language.Metaphone.metaphone(String)
org.apache.commons.codec.binary.Base64Test.testConstructor_Int_ByteArray_Boolean_UrlSafe()	org.apache.commons.codec.binary.StringUtils.newStringUtf8(byte[])
org.apache.commons.codec.language.DoubleMetaphone.doubleMetaphone(String,boolean)	org.apache.commons.codec.language.DoubleMetaphone.handleC(String,DoubleMetaphoneResult,int)
org.apache.commons.codec.binary.BinaryCodec.toAsciiBytes(byte[])	org.apache.commons.codec.binary.BinaryCodec.isEmpty(byte[])
org.apache.commons.codec.binary.Base32InputStreamTest.testBase32EmptyInputStreamMimeChuckSize()	org.apache.commons.codec.binary.Base32InputStreamTest.testBase32EmptyInputStream(int)
org.apache.commons.codec.language.DoubleMetaphone.doubleMetaphone(String,boolean)	org.apache.commons.codec.language.DoubleMetaphone.handleR(String,DoubleMetaphoneResult,int,boolean)
org.apache.commons.codec.binary.HexByteTest.testDecodeHexOddCharacters3()	org.apache.commons.codec.binary.HexByteTest.checkDecodeHexOddCharacters(char[])
org.apache.commons.codec.net.QuotedPrintableBinaryCodecTest.testEncodeObjects()	org.apache.commons.codec.Encoder.encode(I)
org.apache.commons.codec.language.DoubleMetaphone.handleSC(String,DoubleMetaphoneResult,int)	org.apache.commons.codec.language.DoubleMetaphone.isVowel(char)
org.apache.commons.codec.net.QuotedPrintableStringCodec.decode(String,String)	org.apache.commons.codec.net.QuotedPrintableCodec.decode(byte[])
org.apache.commons.codec.language.bm.BeiderMorseEncoderTest.testSpeedCheck2()	org.apache.commons.codec.language.bm.BeiderMorseEncoderTest.createGenericApproxEncoder()
org.apache.commons.codec.digest.DigestUtils.getMd5Digest()	org.apache.commons.codec.digest.DigestUtils.getDigest(String)
org.apache.commons.codec.binary.Base64InputStreamTest.testCodec98NPE()	org.apache.commons.codec.binary.Base64TestData.streamToBytes(InputStream,byte[])
org.apache.commons.codec.binary.Base64TestData.randomData(int,boolean)	org.apache.commons.codec.binary.Base64.encodeBase64URLSafe(byte[])
org.apache.commons.codec.binary.Base64.encodeInteger(BigInteger)	org.apache.commons.codec.binary.Base64.toIntegerBytes(BigInteger)
org.apache.commons.codec.language.bm.PhoneticEngine.PhonemeBuilder.apply(PhonemeExpr)	org.apache.commons.codec.language.bm.Rule.Phoneme.getLanguages()
org.apache.commons.codec.net.URLCodecStringTest.testBasicEncodeDecode()	org.apache.commons.codec.net.URLStringCodec.decode(String)
org.apache.commons.codec.language.DoubleMetaphone.conditionL0(String,int)	org.apache.commons.codec.language.DoubleMetaphone.contains(String,int,int,String,String,String)
org.apache.commons.codec.net.URLCodecStringTest.testDecodeObjects()	org.apache.commons.codec.net.URLStringCodec.decode(String)
org.apache.commons.codec.language.DoubleMetaphone.doubleMetaphone(String,boolean)	org.apache.commons.codec.language.DoubleMetaphone.handleL(String,DoubleMetaphoneResult,int)
org.apache.commons.codec.net.QuotedPrintableStringCodecTest.testSafeCharEncodeDecode()	org.apache.commons.codec.net.QuotedPrintableStringCodec.encode(String)
org.apache.commons.codec.net.URLCodecStringTest.testEncodeUrlWithNullBitSet()	org.apache.commons.codec.net.URLStringCodec.decode(String)
org.apache.commons.codec.language.DoubleMetaphoneTest.assertDoubleMetaphoneAlt(String,String)	org.apache.commons.codec.language.DoubleMetaphone.doubleMetaphone(String,boolean)
org.apache.commons.codec.language.bm.Rule.isMatch(CharSequence)	org.apache.commons.codec.language.bm.Rule.contains(CharSequence,char)
org.apache.commons.codec.binary.HexCharTest.testDecodeHexOddCharacters3()	org.apache.commons.codec.binary.HexCharTest.checkDecodeHexOddCharacters(char[])
org.apache.commons.codec.net.URLCodecStringTest.testUTF8RoundTrip()	org.apache.commons.codec.net.URLStringCodec.encode(String,String)
org.apache.commons.codec.language.bm.BeiderMorseEncoderTest.testSetConcat()	org.apache.commons.codec.language.bm.BeiderMorseEncoder.isConcat()
org.apache.commons.codec.binary.Base32OutputStreamTest.testWriteToNullCoverage()	org.apache.commons.codec.binary.BaseNCodecOutputStream.write(byte[],int,int)
org.apache.commons.codec.binary.Base64Test.testRfc4648Section10EncodeDecode()	org.apache.commons.codec.binary.Base64Test.testEncodeDecode(String)
org.apache.commons.codec.language.MetaphoneTest.testTranslateOfSCHAndCH()	org.apache.commons.codec.language.MetaphoneTest.getMetaphone()
org.apache.commons.codec.binary.Base64Test.testPairs()	org.apache.commons.codec.binary.Base64.encodeBase64(byte[])
org.apache.commons.codec.language.DoubleMetaphone2Test.testDoubleMetaphonePrimary()	org.apache.commons.codec.language.DoubleMetaphone2Test.checkDoubleMetaphone(int,boolean)
org.apache.commons.codec.binary.Base64.decode(byte[],int,int)	org.apache.commons.codec.binary.BaseNCodec.ensureBufferSize(int)
org.apache.commons.codec.binary.BinaryCodec.toAsciiChars(byte[])	org.apache.commons.codec.binary.BinaryCodec.isEmpty(byte[])
org.apache.commons.codec.digest.DigestUtils.getSha384Digest()	org.apache.commons.codec.digest.DigestUtils.getDigest(String)
org.apache.commons.codec.language.bm.BeiderMorseEncoderTest.testAsciiEncodeNotEmpty2Letters()	org.apache.commons.codec.language.bm.BeiderMorseEncoderTest.assertNotEmpty(BeiderMorseEncoder,String)
org.apache.commons.codec.net.URLCodecStringTest.testUTF8RoundTrip()	org.apache.commons.codec.net.URLStringCodec.decode(String,String)
org.apache.commons.codec.binary.Base64Test.testObjectEncode()	org.apache.commons.codec.binary.BaseNCodec.encode(byte[])
org.apache.commons.codec.net.URLCodecStringTest.testBasicEncodeDecode()	org.apache.commons.codec.net.URLStringCodec.encode(String)
org.apache.commons.codec.net.URLCodecBinaryTest.testDecodeInvalidContent()	org.apache.commons.codec.net.URLCodecBinaryTest.validateState(URLBinaryCodec)
org.apache.commons.codec.language.MetaphoneTest.testDiscardOfSilentHAfterG()	org.apache.commons.codec.language.MetaphoneTest.getMetaphone()
org.apache.commons.codec.binary.Base32Test.testSingleCharEncoding()	org.apache.commons.codec.binary.BaseNCodec.readResults(byte[],int,int)
org.apache.commons.codec.binary.Base32Test.testBase32HexSamples()	org.apache.commons.codec.binary.BaseNCodec.encodeAsString(byte[])
org.apache.commons.codec.language.bm.PhoneticEngine.applyFinalRules(PhonemeBuilder,List<Rule>)	org.apache.commons.codec.language.bm.PhoneticEngine.RulesApplication.getI()
org.apache.commons.codec.binary.Base64InputStreamTest.testBase64InputStreamByChunk()	org.apache.commons.codec.binary.Base64InputStreamTest.testByChunk(byte[],byte[],int,byte[])
org.apache.commons.codec.binary.Hex.encode(String)	org.apache.commons.codec.binary.Hex.getCharsetName()
org.apache.commons.codec.binary.Base64Test.testObjectDecodeWithValidParameter()	org.apache.commons.codec.binary.BaseNCodec.decode(byte[])
org.apache.commons.codec.language.DoubleMetaphone.handleSC(String,DoubleMetaphoneResult,int)	org.apache.commons.codec.language.DoubleMetaphone.DoubleMetaphoneResult.append(String)
org.apache.commons.codec.language.Caverphone2Test.testIsCaverphoneEquals()	org.apache.commons.codec.language.AbstractCaverphone.isEncodeEqual(String,String)
org.apache.commons.codec.binary.Base32Test.testRandomBytes()	org.apache.commons.codec.binary.Base32TestData.randomData(BaseNCodec,int)
org.apache.commons.codec.StringEncoderAbstractTest.testLocaleIndependence()	org.apache.commons.codec.StringEncoderAbstractTest.getStringEncoder()
org.apache.commons.codec.binary.HexByteTest.charsetSanityCheck(String)	org.apache.commons.codec.binary.HexByteTest.log(Throwable)
org.apache.commons.codec.binary.Base64Codec13Test.testStaticEncodeChunked()	org.apache.commons.codec.binary.Base64.encodeBase64Chunked(byte[])
org.apache.commons.codec.binary.Base64.decodeBase64(String)	org.apache.commons.codec.binary.BaseNCodec.decode(String)
org.apache.commons.codec.binary.Base64Test.testRfc4648Section10DecodeWithCrLf()	org.apache.commons.codec.binary.StringUtils.newStringUsAscii(byte[])
org.apache.commons.codec.binary.Hex.decodeHex(char[])	org.apache.commons.codec.binary.Hex.toDigit(char,int)
org.apache.commons.codec.language.bm.BeiderMorseEncoderTest.createGenericApproxEncoder()	org.apache.commons.codec.language.bm.BeiderMorseEncoder.setRuleType(RuleType)
org.apache.commons.codec.language.DoubleMetaphoneTest.testSetMaxCodeLength()	org.apache.commons.codec.language.DoubleMetaphone.getMaxCodeLen()
org.apache.commons.codec.language.DoubleMetaphone.doubleMetaphone(String,boolean)	org.apache.commons.codec.language.DoubleMetaphone.handleW(String,DoubleMetaphoneResult,int)
org.apache.commons.codec.language.Soundex.encode(String)	org.apache.commons.codec.language.Soundex.soundex(String)
org.apache.commons.codec.binary.Base32TestData.randomData(BaseNCodec,int)	org.apache.commons.codec.binary.BaseNCodec.encode(byte[])
org.apache.commons.codec.binary.StringUtilsTest.testGetBytesIso8859_1()	org.apache.commons.codec.binary.StringUtilsTest.testGetBytesUnchecked(String)
org.apache.commons.codec.binary.StringUtilsTest.testNewString(String)	org.apache.commons.codec.binary.StringUtils.newString(byte[],String)
org.apache.commons.codec.binary.StringUtilsTest.testGetBytesUtf8()	org.apache.commons.codec.binary.StringUtilsTest.testGetBytesUnchecked(String)
org.apache.commons.codec.digest.DigestUtils.sha256(String)	org.apache.commons.codec.digest.DigestUtils.sha256(byte[])
org.apache.commons.codec.language.DoubleMetaphone.contains(String,int,int,String,String,String,String)	org.apache.commons.codec.language.DoubleMetaphone.contains(String,int,int,String[])
org.apache.commons.codec.binary.BaseNCodecTest.testIsWhiteSpace()	org.apache.commons.codec.binary.BaseNCodec.isWhiteSpace(byte)
org.apache.commons.codec.language.bm.Rule.parseRules(Scanner,String)	org.apache.commons.codec.language.bm.Rule.parsePhonemeExpr(String)
org.apache.commons.codec.binary.Base64InputStreamTest.testBase64InputStreamByteByByte()	org.apache.commons.codec.binary.StringUtils.getBytesUtf8(String)
org.apache.commons.codec.binary.BaseNCodec.encodeToString(byte[])	org.apache.commons.codec.binary.BaseNCodec.encode(byte[])
org.apache.commons.codec.digest.DigestUtils.sha384(String)	org.apache.commons.codec.digest.DigestUtils.getBytesUtf8(String)
org.apache.commons.codec.language.bm.PhoneticEngine.applyFinalRules(PhonemeBuilder,List<Rule>)	org.apache.commons.codec.language.bm.Rule.Phoneme.getLanguages()
org.apache.commons.codec.net.URLCodec.decodeUrl(byte[])	org.apache.commons.codec.net.Utils.digit16(byte)
org.apache.commons.codec.language.bm.BeiderMorseEncoderTest.testSetNameTypeAsh()	org.apache.commons.codec.language.bm.BeiderMorseEncoder.setNameType(NameType)
org.apache.commons.codec.language.DoubleMetaphone.doubleMetaphone(String,boolean)	org.apache.commons.codec.language.DoubleMetaphone.DoubleMetaphoneResult.getAlternate()
org.apache.commons.codec.net.QCodecTest.testBasicEncodeDecode()	org.apache.commons.codec.net.QCodec.decode(String)
org.apache.commons.codec.binary.Base64Test.testDecodePadMarkerIndex3()	org.apache.commons.codec.binary.Base64.decodeBase64(byte[])
org.apache.commons.codec.binary.Base64TestData.streamToBytes(InputStream)	org.apache.commons.codec.binary.Base64TestData.streamToBytes(InputStream,byte[])
org.apache.commons.codec.binary.Base64Test.testRfc4648Section10DecodeWithCrLf()	org.apache.commons.codec.binary.Base64.decodeBase64(String)
org.apache.commons.codec.language.DoubleMetaphone.handleG(String,DoubleMetaphoneResult,int,boolean)	org.apache.commons.codec.language.DoubleMetaphone.DoubleMetaphoneResult.append(String,String)
org.apache.commons.codec.net.URLCodecStringTest.testUTF8RoundTrip()	org.apache.commons.codec.net.URLCodecStringTest.constructString(int[])
org.apache.commons.codec.binary.Base64.encodeBase64Chunked(byte[])	org.apache.commons.codec.binary.Base64.encodeBase64(byte[],boolean)
org.apache.commons.codec.digest.DigestUtils.sha384Hex(InputStream)	org.apache.commons.codec.digest.DigestUtils.sha384(InputStream)
org.apache.commons.codec.binary.Base64InputStreamTest.testMarkSupported()	org.apache.commons.codec.binary.BaseNCodecInputStream.markSupported()
org.apache.commons.codec.digest.DigestUtils.sha384Hex(InputStream)	org.apache.commons.codec.binary.Hex.encodeHexString(byte[])
org.apache.commons.codec.binary.HexByteTest.testEncodeEmpty()	org.apache.commons.codec.binary.HexByteCodec.encode(byte[])
org.apache.commons.codec.net.URLCodecStringTest.testEncodeObjects()	org.apache.commons.codec.net.URLStringCodec.encode(String)
org.apache.commons.codec.binary.BinaryCharCodecTest.testToByteArrayFromString()	org.apache.commons.codec.binary.BinaryCodec.toByteArray(String)
org.apache.commons.codec.language.ColognePhoneticTest.testAychlmajrForCodec122()	org.apache.commons.codec.StringEncoderAbstractTest.checkEncoding(String,String)
org.apache.commons.codec.net.URLStringCodec.encode(String)	org.apache.commons.codec.net.URLStringCodec.encode(String,String)
org.apache.commons.codec.binary.Base64InputStreamTest.testCodec105()	org.apache.commons.codec.binary.BaseNCodecInputStream.read()
org.apache.commons.codec.language.DoubleMetaphone.handleL(String,DoubleMetaphoneResult,int)	org.apache.commons.codec.language.DoubleMetaphone.charAt(String,int)
org.apache.commons.codec.binary.Base32Test.testSingleCharEncoding()	org.apache.commons.codec.binary.BaseNCodec.encode(byte[])
org.apache.commons.codec.binary.StringUtilsTest.testNewStringUtf16Be()	org.apache.commons.codec.binary.StringUtils.newStringUtf16Be(byte[])
org.apache.commons.codec.digest.DigestUtilsTest.testShaHex()	org.apache.commons.codec.digest.DigestUtils.shaHex(String)
org.apache.commons.codec.binary.Base64Codec13Test.testDecoder()	org.apache.commons.codec.binary.Base64Codec13Test.utf8(String)
org.apache.commons.codec.binary.Base64InputStreamTest.testReadOutOfBounds()	org.apache.commons.codec.binary.BaseNCodecInputStream.read(byte[],int,int)
org.apache.commons.codec.binary.Base64.encodeBase64String(byte[])	org.apache.commons.codec.binary.StringUtils.newStringUtf8(byte[])
org.apache.commons.codec.net.URLCodecBinaryTest.testEncodeNull()	org.apache.commons.codec.net.URLCodec.encode(byte[])
org.apache.commons.codec.BinaryEncoderAbstractTest.testEncodeEmpty()	org.apache.commons.codec.BinaryEncoder.encode(byte[])
org.apache.commons.codec.language.SoundexTest.testHWRuleEx2()	org.apache.commons.codec.language.SoundexTest.getSoundexEncoder()
org.apache.commons.codec.net.QCodecTest.testEncodeDecodeBlanks()	org.apache.commons.codec.net.QCodec.encode(String)
org.apache.commons.codec.language.DoubleMetaphone.handleR(String,DoubleMetaphoneResult,int,boolean)	org.apache.commons.codec.language.DoubleMetaphone.charAt(String,int)
org.apache.commons.codec.language.DoubleMetaphone.handleG(String,DoubleMetaphoneResult,int,boolean)	org.apache.commons.codec.language.DoubleMetaphone.isVowel(char)
org.apache.commons.codec.binary.HexByteCodec.encode(byte[])	org.apache.commons.codec.binary.Hex.getCharsetName()
org.apache.commons.codec.binary.Base64Test.testCodeIntegerNull()	org.apache.commons.codec.binary.Base64.encodeInteger(BigInteger)
org.apache.commons.codec.language.SoundexTest.testHWRuleEx3()	org.apache.commons.codec.StringEncoderAbstractTest.checkEncodingVariations(String,String[])
org.apache.commons.codec.binary.HexByteTest.testCustomCharset()	org.apache.commons.codec.binary.HexByteTest.testCustomCharset(String,String)
org.apache.commons.codec.language.DoubleMetaphone.handleW(String,DoubleMetaphoneResult,int)	org.apache.commons.codec.language.DoubleMetaphone.contains(String,int,int,String,String)
org.apache.commons.codec.binary.Base64InputStreamTest.testCodec98NPE()	org.apache.commons.codec.binary.StringUtils.newStringUtf8(byte[])
org.apache.commons.codec.net.URLCodecStringTest.testDefaultEncoding()	org.apache.commons.codec.net.URLStringCodec.encode(String,String)
org.apache.commons.codec.binary.BaseNCodecInputStream.read(byte[],int,int)	org.apache.commons.codec.binary.BaseNCodec.decode(byte[],int,int)
org.apache.commons.codec.binary.BinaryCharCodecTest.testToAsciiString()	org.apache.commons.codec.binary.BinaryCodec.toAsciiString(byte[])
org.apache.commons.codec.digest.DigestUtilsTest.testSha256()	org.apache.commons.codec.digest.DigestUtils.sha256Hex(byte[])
org.apache.commons.codec.binary.Base64.encodeBase64(byte[],boolean)	org.apache.commons.codec.binary.Base64.encodeBase64(byte[],boolean,boolean)
org.apache.commons.codec.digest.DigestUtils.sha(byte[])	org.apache.commons.codec.digest.DigestUtils.getShaDigest()
org.apache.commons.codec.net.QuotedPrintableStringCodecTest.testSafeCharEncodeDecode()	org.apache.commons.codec.net.QuotedPrintableStringCodec.decode(String)
org.apache.commons.codec.language.DoubleMetaphone2Test.getDoubleMetaphone()	org.apache.commons.codec.StringEncoderAbstractTest.getStringEncoder()
org.apache.commons.codec.language.SoundexUtils.difference(StringEncoder,String,String)	org.apache.commons.codec.language.SoundexUtils.differenceEncoded(String,String)
org.apache.commons.codec.binary.HexCharTest.testCustomCharset(String,String)	org.apache.commons.codec.binary.Hex.encodeHexString(byte[])
org.apache.commons.codec.net.QCodecTest.testDecodeStrings()	org.apache.commons.codec.net.QCodec.decode(String)
org.apache.commons.codec.language.DoubleMetaphone.handleJ(String,DoubleMetaphoneResult,int,boolean)	org.apache.commons.codec.language.DoubleMetaphone.DoubleMetaphoneResult.append(char)
org.apache.commons.codec.binary.Base64Test.testCodec112()	org.apache.commons.codec.binary.Base64.encodeBase64(byte[],boolean,boolean,int)
org.apache.commons.codec.binary.StringUtilsTest.testGetBytesUtf16()	org.apache.commons.codec.binary.StringUtils.getBytesUtf16(String)
org.apache.commons.codec.net.QuotedPrintableStringCodecTest.testDecodeWithNullArray()	org.apache.commons.codec.net.QuotedPrintableCodec.decodeQuotedPrintable(byte[])
org.apache.commons.codec.binary.BinaryCodec.decode(char[])	org.apache.commons.codec.binary.BinaryCodec.fromAscii(char[])
org.apache.commons.codec.language.Caverphone1Test.testEndMb()	org.apache.commons.codec.StringEncoderAbstractTest.checkEncodings(String[][])
org.apache.commons.codec.net.QuotedPrintableCodec.decode(byte[])	org.apache.commons.codec.net.QuotedPrintableCodec.decodeQuotedPrintable(byte[])
org.apache.commons.codec.digest.DigestUtils.sha512Hex(byte[])	org.apache.commons.codec.binary.Hex.encodeHexString(byte[])
org.apache.commons.codec.binary.HexByteTest.testHelloWorldLowerCaseHex()	org.apache.commons.codec.binary.Hex.encodeHex(byte[],boolean)
org.apache.commons.codec.binary.Base32InputStreamTest.testBase32InputStreamByteByByte()	org.apache.commons.codec.binary.StringUtils.getBytesUtf8(String)
org.apache.commons.codec.binary.Base64InputStreamTest.testBase64EmptyInputStreamMimeChuckSize()	org.apache.commons.codec.binary.Base64InputStreamTest.testBase64EmptyInputStream(int)
org.apache.commons.codec.language.DoubleMetaphone.handleR(String,DoubleMetaphoneResult,int,boolean)	org.apache.commons.codec.language.DoubleMetaphone.contains(String,int,int,String)
org.apache.commons.codec.language.DoubleMetaphone.handleD(String,DoubleMetaphoneResult,int)	org.apache.commons.codec.language.DoubleMetaphone.contains(String,int,int,String,String)
org.apache.commons.codec.binary.Base64Test.testCodeInteger2()	org.apache.commons.codec.binary.Base64.decodeInteger(byte[])
org.apache.commons.codec.net.BCodec.doDecoding(byte[])	org.apache.commons.codec.binary.Base64.decodeBase64(byte[])
org.apache.commons.codec.binary.HexCharTest.testDecodeHexOddCharacters1()	org.apache.commons.codec.binary.HexCharTest.checkDecodeHexOddCharacters(char[])
org.apache.commons.codec.language.SoundexTest.testMsSqlServer3()	org.apache.commons.codec.language.Soundex.encode(String)
org.apache.commons.codec.binary.Base64Test.testObjectEncodeWithValidParameter()	org.apache.commons.codec.binary.Base64.decodeBase64(byte[])
org.apache.commons.codec.binary.Base64OutputStreamTest.testCodec98NPE()	org.apache.commons.codec.binary.StringUtils.getBytesUtf8(String)
org.apache.commons.codec.language.bm.BeiderMorseEncoderTest.testSetRuleTypeExact()	org.apache.commons.codec.language.bm.BeiderMorseEncoder.setRuleType(RuleType)
org.apache.commons.codec.language.bm.BeiderMorseEncoderTest.testSetNameTypeAsh()	org.apache.commons.codec.language.bm.BeiderMorseEncoder.getNameType()
org.apache.commons.codec.binary.Base32OutputStreamTest.testBase32EmptyOutputStreamMimeChunkSize()	org.apache.commons.codec.binary.Base32OutputStreamTest.testBase32EmptyOutputStream(int)
org.apache.commons.codec.net.RFC1522Codec.encodeText(String,String)	org.apache.commons.codec.net.RFC1522Codec.doEncoding(byte[])
org.apache.commons.codec.language.DoubleMetaphone.conditionC0(String,int)	org.apache.commons.codec.language.DoubleMetaphone.contains(String,int,int,String)
org.apache.commons.codec.net.BCodecTest.testDecodeStrings()	org.apache.commons.codec.net.BCodec.decode(String)
org.apache.commons.codec.language.MetaphoneTest.testWordEndingInMB()	org.apache.commons.codec.language.MetaphoneTest.getMetaphone()
org.apache.commons.codec.digest.DigestUtils.sha384(InputStream)	org.apache.commons.codec.digest.DigestUtils.getSha384Digest()
org.apache.commons.codec.language.SoundexTest.testHWRuleEx3()	org.apache.commons.codec.language.SoundexTest.getSoundexEncoder()
org.apache.commons.codec.language.MetaphoneTest.testIsMetaphoneEqualJohn()	org.apache.commons.codec.language.MetaphoneTest.assertIsMetaphoneEqual(String,String[])
org.apache.commons.codec.language.SoundexTest.testDifference()	org.apache.commons.codec.language.SoundexTest.getSoundexEncoder()
org.apache.commons.codec.binary.Base64.encodeBase64URLSafeString(byte[])	org.apache.commons.codec.binary.StringUtils.newStringUtf8(byte[])
org.apache.commons.codec.language.ColognePhonetic.colognePhonetic(String)	org.apache.commons.codec.language.ColognePhonetic.CologneOutputBuffer.addRight(char)
org.apache.commons.codec.language.bm.BeiderMorseEncoderTest.testEncodeAtzNotEmpty()	org.apache.commons.codec.language.bm.BeiderMorseEncoderTest.assertNotEmpty(BeiderMorseEncoder,String)
org.apache.commons.codec.language.MetaphoneTest.testTCH()	org.apache.commons.codec.language.Metaphone.metaphone(String)
org.apache.commons.codec.language.MetaphoneTest.assertIsMetaphoneEqual(String,String[])	org.apache.commons.codec.language.Metaphone.isMetaphoneEqual(String,String)
org.apache.commons.codec.language.MetaphoneTest.testPHTOF()	org.apache.commons.codec.language.Metaphone.metaphone(String)
org.apache.commons.codec.language.DoubleMetaphone.handleH(String,DoubleMetaphoneResult,int)	org.apache.commons.codec.language.DoubleMetaphone.isVowel(char)
org.apache.commons.codec.net.QCodecTest.testUTF8RoundTrip()	org.apache.commons.codec.net.QCodec.encode(String)
org.apache.commons.codec.BinaryEncoderAbstractTest.testEncodeNull()	org.apache.commons.codec.BinaryEncoderAbstractTest.makeEncoder()
org.apache.commons.codec.binary.Base64Test.testObjectEncodeWithValidParameter()	org.apache.commons.codec.binary.BaseNCodec.encode(byte[])
org.apache.commons.codec.language.RefinedSoundexTest.testNewInstance3()	org.apache.commons.codec.language.RefinedSoundex.soundex(String)
org.apache.commons.codec.net.BCodecTest.testDecodeStringWithNull()	org.apache.commons.codec.net.BCodec.decode(String)
org.apache.commons.codec.digest.DigestUtils.md5(String)	org.apache.commons.codec.digest.DigestUtils.md5(byte[])
org.apache.commons.codec.binary.BaseNCodecOutputStream.flush(boolean)	org.apache.commons.codec.binary.BaseNCodec.readResults(byte[],int,int)
org.apache.commons.codec.binary.HexByteTest.testCustomCharsetBadNameDecodeObject()	org.apache.commons.codec.binary.Hex.decode(byte[])
org.apache.commons.codec.language.bm.Rule.createResourceName(NameType,RuleType,String)	org.apache.commons.codec.language.bm.RuleType.getName()
org.apache.commons.codec.binary.HexByteTest.charsetSanityCheck(String)	org.apache.commons.codec.binary.HexByteTest.log(String)
org.apache.commons.codec.language.DoubleMetaphone.doubleMetaphone(String,boolean)	org.apache.commons.codec.language.DoubleMetaphone.DoubleMetaphoneResult.isComplete()
org.apache.commons.codec.binary.Base32InputStreamTest.testReadOutOfBounds()	org.apache.commons.codec.binary.BaseNCodecInputStream.read(byte[],int,int)
org.apache.commons.codec.net.URLCodecStringTest.testDecodeInvalid()	org.apache.commons.codec.net.URLStringCodec.decode(String)
org.apache.commons.codec.language.DoubleMetaphoneTest.testSetMaxCodeLength()	org.apache.commons.codec.language.DoubleMetaphone.setMaxCodeLen(int)
org.apache.commons.codec.language.DoubleMetaphone.DoubleMetaphoneResult.append(String,String)	org.apache.commons.codec.language.DoubleMetaphone.DoubleMetaphoneResult.appendAlternate(String)
org.apache.commons.codec.language.SoundexTest.testUsMappingEWithAcute()	org.apache.commons.codec.language.SoundexTest.getSoundexEncoder()
org.apache.commons.codec.binary.StringUtils.getBytesIso8859_1(String)	org.apache.commons.codec.binary.StringUtils.getBytesUnchecked(String,String)
org.apache.commons.codec.binary.Base64InputStreamTest.testBase64EmptyInputStream(int)	org.apache.commons.codec.binary.Base64InputStreamTest.testByteByByte(byte[],byte[],int,byte[])
org.apache.commons.codec.language.DoubleMetaphone.handleW(String,DoubleMetaphoneResult,int)	org.apache.commons.codec.language.DoubleMetaphone.DoubleMetaphoneResult.append(String,String)
org.apache.commons.codec.language.SoundexTest.testMsSqlServer1()	org.apache.commons.codec.language.Soundex.encode(String)
org.apache.commons.codec.binary.Base64Test.testUUID()	org.apache.commons.codec.binary.Base64.encodeBase64URLSafe(byte[])
org.apache.commons.codec.language.DoubleMetaphoneTest.testIsDoubleMetaphoneEqualExtended2()	org.apache.commons.codec.language.DoubleMetaphoneTest.doubleMetaphoneEqualTest(String[][],boolean)
org.apache.commons.codec.language.DoubleMetaphone.handleCC(String,DoubleMetaphoneResult,int)	org.apache.commons.codec.language.DoubleMetaphone.charAt(String,int)
org.apache.commons.codec.net.QCodecTest.testUTF8RoundTrip()	org.apache.commons.codec.net.QCodec.decode(String)
org.apache.commons.codec.language.SoundexTest.testB650()	org.apache.commons.codec.StringEncoderAbstractTest.checkEncodingVariations(String,String[])
org.apache.commons.codec.binary.StringUtilsTest.testGetBytesUtf16()	org.apache.commons.codec.binary.StringUtilsTest.testGetBytesUnchecked(String)
org.apache.commons.codec.language.DoubleMetaphone.handleS(String,DoubleMetaphoneResult,int,boolean)	org.apache.commons.codec.language.DoubleMetaphone.DoubleMetaphoneResult.append(char,char)
org.apache.commons.codec.net.BCodecTest.testInvalidEncoding()	org.apache.commons.codec.net.BCodec.encode(String)
org.apache.commons.codec.digest.DigestUtils.md5Hex(InputStream)	org.apache.commons.codec.digest.DigestUtils.md5(InputStream)
org.apache.commons.codec.language.DoubleMetaphone.handleG(String,DoubleMetaphoneResult,int,boolean)	org.apache.commons.codec.language.DoubleMetaphone.DoubleMetaphoneResult.append(String)
org.apache.commons.codec.language.DoubleMetaphone.conditionCH0(String,int)	org.apache.commons.codec.language.DoubleMetaphone.contains(String,int,int,String,String)
org.apache.commons.codec.language.ColognePhonetic.encode(String)	org.apache.commons.codec.language.ColognePhonetic.colognePhonetic(String)
org.apache.commons.codec.language.MetaphoneTest.testSHAndSIOAndSIAToX()	org.apache.commons.codec.language.Metaphone.metaphone(String)
org.apache.commons.codec.language.DoubleMetaphone.conditionCH1(String,int)	org.apache.commons.codec.language.DoubleMetaphone.contains(String,int,int,String,String,String,String)
org.apache.commons.codec.binary.HexByteTest.testRequiredCharset()	org.apache.commons.codec.binary.HexByteTest.testCustomCharset(String,String)
org.apache.commons.codec.net.URLCodecStringTest.testSafeCharEncodeDecode()	org.apache.commons.codec.net.URLCodecStringTest.validateState(URLStringCodec)
org.apache.commons.codec.binary.BaseNCodec.decode(byte[])	org.apache.commons.codec.binary.BaseNCodec.decode(byte[],int,int)
org.apache.commons.codec.language.MetaphoneTest.testTranslateOfSCHAndCH()	org.apache.commons.codec.language.Metaphone.metaphone(String)
org.apache.commons.codec.binary.Base64Test.testUrlSafe()	org.apache.commons.codec.binary.Base64.decodeBase64(byte[])
org.apache.commons.codec.language.DoubleMetaphone.contains(String,int,int,String)	org.apache.commons.codec.language.DoubleMetaphone.contains(String,int,int,String[])
org.apache.commons.codec.binary.Base32InputStreamTest.testBase32InputStreamByChunk()	org.apache.commons.codec.binary.StringUtils.getBytesUtf8(String)
org.apache.commons.codec.binary.Base64Test.testTriplets()	org.apache.commons.codec.binary.Base64.encodeBase64(byte[])
org.apache.commons.codec.language.DoubleMetaphone.handleD(String,DoubleMetaphoneResult,int)	org.apache.commons.codec.language.DoubleMetaphone.DoubleMetaphoneResult.append(String)
org.apache.commons.codec.net.URLCodecStringTest.testDefaultEncoding()	org.apache.commons.codec.net.URLStringCodec.encode(String)
org.apache.commons.codec.language.Metaphone.metaphone(String)	org.apache.commons.codec.language.Metaphone.isNextChar(StringBuffer,int,char)
org.apache.commons.codec.net.QCodecTest.testEncodeDecodeBlanks()	org.apache.commons.codec.net.QCodec.decode(String)
org.apache.commons.codec.binary.StringUtils.getBytesUtf16Le(String)	org.apache.commons.codec.binary.StringUtils.getBytesUnchecked(String,String)
org.apache.commons.codec.language.ColognePhonetic.isEncodeEqual(String,String)	org.apache.commons.codec.language.ColognePhonetic.colognePhonetic(String)
org.apache.commons.codec.language.bm.PhoneticEngine.applyFinalRules(PhonemeBuilder,List<Rule>)	org.apache.commons.codec.language.bm.PhoneticEngine.RulesApplication.invoke()
org.apache.commons.codec.binary.HexCharTest.testEncodeDecodeRandom()	org.apache.commons.codec.binary.Hex.decode(char[])
org.apache.commons.codec.language.SoundexTest.testUsMappingOWithDiaeresis()	org.apache.commons.codec.language.Soundex.encode(String)
org.apache.commons.codec.language.Caverphone2Test.testCaverphoneRevisitedRandomWords()	org.apache.commons.codec.StringEncoderAbstractTest.checkEncoding(String,String)
org.apache.commons.codec.binary.Base64Test.testEncodeDecodeRandom()	org.apache.commons.codec.binary.Base64.isBase64(byte[])
org.apache.commons.codec.net.QuotedPrintableStringCodecTest.testUnsafeEncodeDecode()	org.apache.commons.codec.net.QuotedPrintableStringCodec.decode(String)
org.apache.commons.codec.binary.StringUtils.newStringIso8859_1(byte[])	org.apache.commons.codec.binary.StringUtils.newString(byte[],String)
org.apache.commons.codec.language.DoubleMetaphone.handleG(String,DoubleMetaphoneResult,int,boolean)	org.apache.commons.codec.language.DoubleMetaphone.charAt(String,int)
org.apache.commons.codec.binary.Base64Test.testDecodeEncode(String)	org.apache.commons.codec.binary.Base64.encodeBase64String(byte[])
org.apache.commons.codec.binary.HexByteTest.testDencodeEmpty()	org.apache.commons.codec.binary.Hex.decode(String)
org.apache.commons.codec.language.MetaphoneTest.testIsMetaphoneEqualSusan()	org.apache.commons.codec.language.MetaphoneTest.assertIsMetaphoneEqual(String,String[])
org.apache.commons.codec.language.DoubleMetaphone.handleC(String,DoubleMetaphoneResult,int)	org.apache.commons.codec.language.DoubleMetaphone.charAt(String,int)
org.apache.commons.codec.net.QCodecTest.testEncodeDecodeNull()	org.apache.commons.codec.net.QCodec.encode(String)
org.apache.commons.codec.binary.StringUtilsTest.testNewStringUtf16()	org.apache.commons.codec.binary.StringUtilsTest.testNewString(String)
org.apache.commons.codec.language.DoubleMetaphone.doubleMetaphone(String,boolean)	org.apache.commons.codec.language.DoubleMetaphone.handleS(String,DoubleMetaphoneResult,int,boolean)
org.apache.commons.codec.binary.HexCharTest.testEncodeEmpty()	org.apache.commons.codec.binary.Hex.encodeHex(byte[])
org.apache.commons.codec.language.DoubleMetaphone.handleR(String,DoubleMetaphoneResult,int,boolean)	org.apache.commons.codec.language.DoubleMetaphone.DoubleMetaphoneResult.appendAlternate(char)
org.apache.commons.codec.binary.Base64OutputStreamTest.testWriteToNullCoverage()	org.apache.commons.codec.binary.BaseNCodecOutputStream.write(byte[],int,int)
org.apache.commons.codec.binary.HexCharTest.testCustomCharset(String,String)	org.apache.commons.codec.binary.HexCharTest.charsetSanityCheck(String)
org.apache.commons.codec.language.MetaphoneTest.testIsMetaphoneEqualKnight()	org.apache.commons.codec.language.MetaphoneTest.assertIsMetaphoneEqual(String,String[])
org.apache.commons.codec.language.DoubleMetaphone.contains(String,int,int,String,String,String,String,String)	org.apache.commons.codec.language.DoubleMetaphone.contains(String,int,int,String[])
org.apache.commons.codec.binary.Base64Test.testStringToByteVariations()	org.apache.commons.codec.binary.Base64.decodeBase64(String)
org.apache.commons.codec.net.URLCodecStringTest.testEncodeObjects()	org.apache.commons.codec.net.URLCodecStringTest.validateState(URLStringCodec)
org.apache.commons.codec.language.DoubleMetaphone.doubleMetaphone(String,boolean)	org.apache.commons.codec.language.DoubleMetaphone.handleT(String,DoubleMetaphoneResult,int)
org.apache.commons.codec.language.bm.PhoneticEngineTest.testEncode()	org.apache.commons.codec.language.bm.PhoneticEngine.encode(String)
org.apache.commons.codec.language.bm.BeiderMorseEncoderTest.testInvalidLangIllegalStateException()	org.apache.commons.codec.language.bm.Languages.getInstance(NameType)
org.apache.commons.codec.net.QuotedPrintableStringCodecTest.testDecodeStrings()	org.apache.commons.codec.net.QuotedPrintableStringCodec.decode(String)
org.apache.commons.codec.binary.StringUtilsTest.testNewStringIso8859_1()	org.apache.commons.codec.binary.StringUtils.newStringIso8859_1(byte[])
org.apache.commons.codec.digest.DigestUtilsTest.testSha384()	org.apache.commons.codec.digest.DigestUtils.sha384Hex(byte[])
org.apache.commons.codec.language.bm.BeiderMorseEncoderTest.testInvalidLanguageIllegalArgumentException()	org.apache.commons.codec.language.bm.Languages.getInstance(String)
org.apache.commons.codec.binary.Base64Codec13Test.testStaticDecodeChunked()	org.apache.commons.codec.binary.Base64Codec13Test.utf8(String)
org.apache.commons.codec.language.MetaphoneTest.testSHAndSIOAndSIAToX()	org.apache.commons.codec.language.MetaphoneTest.getMetaphone()
org.apache.commons.codec.binary.Base64Test.testUrlSafe()	org.apache.commons.codec.binary.Base64TestData.randomData(int,boolean)
org.apache.commons.codec.language.MetaphoneTest.testIsMetaphoneEqualWright()	org.apache.commons.codec.language.MetaphoneTest.assertIsMetaphoneEqual(String,String[])
org.apache.commons.codec.language.MetaphoneTest.testTCH()	org.apache.commons.codec.language.MetaphoneTest.getMetaphone()
org.apache.commons.codec.language.DoubleMetaphoneTest.assertDoubleMetaphone(String,String)	org.apache.commons.codec.language.DoubleMetaphone.encode(String)
org.apache.commons.codec.binary.BaseNCodecInputStream.read(byte[],int,int)	org.apache.commons.codec.binary.BaseNCodec.readResults(byte[],int,int)
org.apache.commons.codec.binary.StringUtilsTest.testGetBytesUtf16Be()	org.apache.commons.codec.binary.StringUtils.getBytesUtf16Be(String)
org.apache.commons.codec.language.Soundex.getMappingCode(String,int)	org.apache.commons.codec.language.Soundex.map(char)
org.apache.commons.codec.language.bm.Rule.isMatch(CharSequence)	org.apache.commons.codec.language.bm.Rule.endsWith(CharSequence,CharSequence)
org.apache.commons.codec.net.URLCodecStringTest.testEncodeStringWithNull()	org.apache.commons.codec.net.URLStringCodec.encode(String,String)
org.apache.commons.codec.binary.Base64Test.testIsStringBase64()	org.apache.commons.codec.binary.Base64.isBase64(String)
org.apache.commons.codec.net.QuotedPrintableStringCodecTest.testInvalidEncoding()	org.apache.commons.codec.net.QuotedPrintableStringCodec.encode(String)
org.apache.commons.codec.binary.Base64InputStreamTest.testBase64InputStreamByChunk()	org.apache.commons.codec.binary.Base64TestData.randomData(int,boolean)
org.apache.commons.codec.language.DoubleMetaphone.handleG(String,DoubleMetaphoneResult,int,boolean)	org.apache.commons.codec.language.DoubleMetaphone.contains(String,int,int,String[])
org.apache.commons.codec.net.BCodecTest.testEncodeStringWithNull()	org.apache.commons.codec.net.BCodec.encode(String,String)
org.apache.commons.codec.language.DoubleMetaphone.handleGH(String,DoubleMetaphoneResult,int)	org.apache.commons.codec.language.DoubleMetaphone.DoubleMetaphoneResult.append(char)
org.apache.commons.codec.binary.Base64Codec13Test.testStaticDecodeChunked()	org.apache.commons.codec.binary.Base64.decodeBase64(byte[])
org.apache.commons.codec.binary.Base64Test.testIsUrlSafe()	org.apache.commons.codec.binary.Base64.isUrlSafe()
org.apache.commons.codec.language.bm.PhoneticEngine.applyFinalRules(PhonemeBuilder,List<Rule>)	org.apache.commons.codec.language.bm.PhoneticEngine.PhonemeBuilder.empty(LanguageSet)
org.apache.commons.codec.language.bm.Rule.pattern(String)	org.apache.commons.codec.language.bm.Rule.endsWith(CharSequence,CharSequence)
org.apache.commons.codec.net.QCodec.doDecoding(byte[])	org.apache.commons.codec.net.QuotedPrintableCodec.decodeQuotedPrintable(byte[])
org.apache.commons.codec.binary.BinaryCharCodecTest.assertDecodeObject(byte[],String)	org.apache.commons.codec.binary.BinaryCodec.decode(byte[])
org.apache.commons.codec.language.Metaphone.isMetaphoneEqual(String,String)	org.apache.commons.codec.language.Metaphone.metaphone(String)
org.apache.commons.codec.binary.HexCharTest.testEncodeDecodeRandom()	org.apache.commons.codec.binary.HexCharCodec.encode(byte[])
org.apache.commons.codec.binary.StringUtilsTest.testNewStringBadEnc()	org.apache.commons.codec.binary.StringUtils.newString(byte[],String)
org.apache.commons.codec.binary.Base32InputStreamTest.testRead0()	org.apache.commons.codec.binary.StringUtils.getBytesUtf8(String)
org.apache.commons.codec.net.QCodecTest.testEncodeDecodeNull()	org.apache.commons.codec.net.QCodec.decode(String)
org.apache.commons.codec.binary.BinaryCharCodecTest.assertDecodeObject(byte[],String)	org.apache.commons.codec.binary.BinaryCodec.decode(char[])
org.apache.commons.codec.digest.DigestUtilsTest.testShaHex()	org.apache.commons.codec.digest.DigestUtils.shaHex(byte[])
org.apache.commons.codec.net.QCodecTest.testBasicEncodeDecode()	org.apache.commons.codec.net.QCodec.encode(String)
org.apache.commons.codec.StringEncoderAbstractTest.testEncodeNull()	org.apache.commons.codec.StringEncoderAbstractTest.getStringEncoder()
org.apache.commons.codec.binary.Base64Test.testEncodeOverMaxSize(int)	org.apache.commons.codec.binary.Base64.encodeBase64(byte[],boolean,boolean,int)
org.apache.commons.codec.language.DoubleMetaphone.handleT(String,DoubleMetaphoneResult,int)	org.apache.commons.codec.language.DoubleMetaphone.DoubleMetaphoneResult.append(char,char)
org.apache.commons.codec.net.QuotedPrintableStringCodecTest.testSoftLineBreakDecode()	org.apache.commons.codec.net.QuotedPrintableStringCodec.decode(String)
org.apache.commons.codec.language.MetaphoneTest.testDiscardOfSilentGN()	org.apache.commons.codec.language.Metaphone.metaphone(String)
org.apache.commons.codec.language.DoubleMetaphone.doubleMetaphone(String,boolean)	org.apache.commons.codec.language.DoubleMetaphone.DoubleMetaphoneResult.append(char)
org.apache.commons.codec.binary.Base64Test.testIsUrlSafe()	org.apache.commons.codec.binary.Base64.isBase64(byte[])
org.apache.commons.codec.net.QuotedPrintableStringCodecTest.testUnsafeEncodeDecode()	org.apache.commons.codec.net.QuotedPrintableStringCodec.encode(String)
org.apache.commons.codec.digest.DigestUtils.sha256Hex(InputStream)	org.apache.commons.codec.binary.Hex.encodeHexString(byte[])
org.apache.commons.codec.language.DoubleMetaphone.handleJ(String,DoubleMetaphoneResult,int,boolean)	org.apache.commons.codec.language.DoubleMetaphone.contains(String,int,int,String,String,String)
org.apache.commons.codec.binary.Base32InputStreamTest.testBase32InputStreamByChunk()	org.apache.commons.codec.binary.Base32TestData.randomData(BaseNCodec,int)
org.apache.commons.codec.binary.Base64Test.testEmptyBase64()	org.apache.commons.codec.binary.Base64.encodeBase64(byte[])
org.apache.commons.codec.binary.BaseNCodecOutputStream.write(byte[],int,int)	org.apache.commons.codec.binary.BaseNCodec.decode(byte[],int,int)
org.apache.commons.codec.language.DoubleMetaphone.handleG(String,DoubleMetaphoneResult,int,boolean)	org.apache.commons.codec.language.DoubleMetaphone.DoubleMetaphoneResult.append(char)
org.apache.commons.codec.language.DoubleMetaphone.conditionL0(String,int)	org.apache.commons.codec.language.DoubleMetaphone.contains(String,int,int,String)
org.apache.commons.codec.binary.Base64Test.testCodeInteger3()	org.apache.commons.codec.binary.Base64.encodeInteger(BigInteger)
org.apache.commons.codec.binary.StringUtilsTest.testNewStringUsAscii()	org.apache.commons.codec.binary.StringUtilsTest.testNewString(String)
org.apache.commons.codec.binary.Base32OutputStreamTest.testBase32OutputStreamByChunk()	org.apache.commons.codec.binary.Base32OutputStreamTest.testByChunk(byte[],byte[],int,byte[])
org.apache.commons.codec.language.DoubleMetaphone.doubleMetaphone(String,boolean)	org.apache.commons.codec.language.DoubleMetaphone.handleX(String,DoubleMetaphoneResult,int)
org.apache.commons.codec.net.URLCodecStringTest.testUnsafeEncodeDecode()	org.apache.commons.codec.net.URLStringCodec.decode(String)
org.apache.commons.codec.binary.StringUtils.newStringUtf16Be(byte[])	org.apache.commons.codec.binary.StringUtils.newString(byte[],String)
org.apache.commons.codec.digest.DigestUtils.shaHex(byte[])	org.apache.commons.codec.binary.Hex.encodeHexString(byte[])
org.apache.commons.codec.language.DoubleMetaphone.handleGH(String,DoubleMetaphoneResult,int)	org.apache.commons.codec.language.DoubleMetaphone.contains(String,int,int,String,String)
org.apache.commons.codec.net.BCodecTest.testInvalidEncoding()	org.apache.commons.codec.net.BCodec.decode(String)
org.apache.commons.codec.binary.Base32InputStreamTest.testReadOutOfBounds()	org.apache.commons.codec.binary.StringUtils.getBytesUtf8(String)
org.apache.commons.codec.language.bm.RuleTest.testSubSequenceWorks()	org.apache.commons.codec.language.bm.Rule.Phoneme.append(CharSequence)
org.apache.commons.codec.binary.Base64.encodeBase64URLSafeString(byte[])	org.apache.commons.codec.binary.Base64.encodeBase64(byte[],boolean,boolean)
org.apache.commons.codec.binary.Base64Test.testBase64()	org.apache.commons.codec.binary.BaseNCodec.decode(String)
org.apache.commons.codec.binary.BaseNCodecTest.testContainsAlphabetOrPad()	org.apache.commons.codec.binary.BaseNCodec.containsAlphabetOrPad(byte[])
org.apache.commons.codec.language.DoubleMetaphone.handleSC(String,DoubleMetaphoneResult,int)	org.apache.commons.codec.language.DoubleMetaphone.contains(String,int,int,String,String)
org.apache.commons.codec.language.SoundexTest.testNewInstance2()	org.apache.commons.codec.language.Soundex.soundex(String)
org.apache.commons.codec.language.bm.Lang.guessLanguage(String)	org.apache.commons.codec.language.bm.Languages.LanguageSet.getAny()
org.apache.commons.codec.digest.DigestUtils.sha(String)	org.apache.commons.codec.digest.DigestUtils.sha(byte[])
org.apache.commons.codec.binary.Base32OutputStreamTest.testBase32OutputStreamByteByByte()	org.apache.commons.codec.binary.Base32OutputStreamTest.testByteByByte(byte[],byte[],int,byte[])
org.apache.commons.codec.net.QuotedPrintableStringCodecTest.testDecodeStringWithNull()	org.apache.commons.codec.net.QuotedPrintableStringCodec.decode(String,String)
org.apache.commons.codec.net.QuotedPrintableStringCodec.encode(String,String)	org.apache.commons.codec.binary.StringUtils.newStringUsAscii(byte[])
org.apache.commons.codec.language.DoubleMetaphoneTest.doubleMetaphoneEqualTest(String[][],boolean)	org.apache.commons.codec.language.DoubleMetaphone.isDoubleMetaphoneEqual(String,String,boolean)
org.apache.commons.codec.language.SoundexTest.testEncodeBatch3()	org.apache.commons.codec.language.SoundexTest.getSoundexEncoder()
org.apache.commons.codec.binary.HexByteTest.testCustomCharsetBadNameEncodeObject()	org.apache.commons.codec.binary.Hex.encode(String)
org.apache.commons.codec.binary.Base64InputStreamTest.testBase64InputStreamByChunk()	org.apache.commons.codec.binary.StringUtils.getBytesUtf8(String)
org.apache.commons.codec.net.QCodecTest.testUTF8RoundTrip()	org.apache.commons.codec.net.QCodecTest.constructString(int[])
org.apache.commons.codec.binary.Base64Test.testUUID()	org.apache.commons.codec.binary.Base64.decodeBase64(byte[])
org.apache.commons.codec.binary.Base32InputStreamTest.testBase32InputStreamByChunk()	org.apache.commons.codec.binary.Base32InputStreamTest.testByChunk(byte[],byte[],int,byte[])
org.apache.commons.codec.language.SoundexTest.testEncodeIgnoreHyphens()	org.apache.commons.codec.StringEncoderAbstractTest.checkEncodingVariations(String,String[])
org.apache.commons.codec.language.bm.PhoneticEngine.RulesApplication.invoke()	org.apache.commons.codec.language.bm.Rule.patternAndContextMatches(CharSequence,int)
org.apache.commons.codec.language.DoubleMetaphoneTest.testIsDoubleMetaphoneEqualExtended3()	org.apache.commons.codec.language.DoubleMetaphoneTest.validateFixture(String[][])
org.apache.commons.codec.digest.DigestUtils.sha512(String)	org.apache.commons.codec.digest.DigestUtils.sha512(byte[])
org.apache.commons.codec.binary.Base64Test.testEmptyBase64()	org.apache.commons.codec.binary.Base64.decodeBase64(byte[])
org.apache.commons.codec.language.Caverphone2Test.testEndMb()	org.apache.commons.codec.StringEncoderAbstractTest.checkEncodings(String[][])
org.apache.commons.codec.binary.BinaryCharCodecTest.testToAsciiChars()	org.apache.commons.codec.binary.BinaryCodec.toAsciiChars(byte[])
org.apache.commons.codec.language.bm.BeiderMorseEncoderTest.testSetRuleTypeExact()	org.apache.commons.codec.language.bm.BeiderMorseEncoder.getRuleType()
org.apache.commons.codec.net.QuotedPrintableBinaryCodecTest.testEncodeNull()	org.apache.commons.codec.net.QuotedPrintableCodec.encode(byte[])
org.apache.commons.codec.net.URLCodecStringTest.testEncodeUrlWithNullBitSet()	org.apache.commons.codec.net.URLCodec.encodeUrl(BitSet,byte[])
org.apache.commons.codec.binary.BinaryCharCodec.encode(byte[])	org.apache.commons.codec.binary.BinaryCodec.toAsciiChars(byte[])
org.apache.commons.codec.binary.HexCharTest.charsetSanityCheck(String)	org.apache.commons.codec.binary.HexCharTest.log(Throwable)
org.apache.commons.codec.digest.DigestUtilsTest.testMD5HexLength()	org.apache.commons.codec.digest.DigestUtils.md5Hex(byte[])
org.apache.commons.codec.language.SoundexUtils.difference(StringEncoder,String,String)	org.apache.commons.codec.StringEncoder.encode(String)
org.apache.commons.codec.binary.StringUtils.newStringUsAscii(byte[])	org.apache.commons.codec.binary.StringUtils.newString(byte[],String)
org.apache.commons.codec.binary.HexCharTest.testDecodeBadCharacterPos0()	org.apache.commons.codec.binary.Hex.decode(String)
org.apache.commons.codec.language.DoubleMetaphone.handleW(String,DoubleMetaphoneResult,int)	org.apache.commons.codec.language.DoubleMetaphone.DoubleMetaphoneResult.appendAlternate(char)
org.apache.commons.codec.language.MetaphoneTest.testIsMetaphoneEqualGary()	org.apache.commons.codec.language.MetaphoneTest.assertIsMetaphoneEqual(String,String[])
org.apache.commons.codec.language.DoubleMetaphoneTest.testSetMaxCodeLength()	org.apache.commons.codec.language.DoubleMetaphone.doubleMetaphone(String,boolean)
org.apache.commons.codec.language.bm.PhoneticEngine.encode(String,LanguageSet)	org.apache.commons.codec.language.bm.PhoneticEngine.RulesApplication.invoke()
org.apache.commons.codec.language.Soundex.soundex(String)	org.apache.commons.codec.language.Soundex.getMappingCode(String,int)
org.apache.commons.codec.language.ColognePhoneticTest.testIsEncodeEquals()	org.apache.commons.codec.language.ColognePhonetic.isEncodeEqual(String,String)
org.apache.commons.codec.language.DoubleMetaphone.handleCH(String,DoubleMetaphoneResult,int)	org.apache.commons.codec.language.DoubleMetaphone.DoubleMetaphoneResult.append(char,char)
org.apache.commons.codec.binary.Base64Test.testEncodeDecodeRandom()	org.apache.commons.codec.binary.Base64.decodeBase64(byte[])
org.apache.commons.codec.binary.BinaryCodec.toByteArray(String)	org.apache.commons.codec.binary.BinaryCodec.fromAscii(char[])
org.apache.commons.codec.language.DoubleMetaphoneTest.testIsDoubleMetaphoneEqualWithMATCHES()	org.apache.commons.codec.language.DoubleMetaphoneTest.validateFixture(String[][])
org.apache.commons.codec.language.bm.BeiderMorseEncoderTest.testEncodeGna()	org.apache.commons.codec.language.bm.BeiderMorseEncoderTest.createGenericApproxEncoder()
org.apache.commons.codec.digest.DigestUtilsTest.testSha512()	org.apache.commons.codec.digest.DigestUtils.sha512Hex(byte[])
org.apache.commons.codec.binary.Base64InputStreamTest.testCodec101()	org.apache.commons.codec.binary.StringUtils.getBytesUtf8(String)
org.apache.commons.codec.StringEncoderAbstractTest.testEncodeNull()	org.apache.commons.codec.StringEncoder.encode(String)
org.apache.commons.codec.net.URLCodecStringTest.testDecodeInvalidContent()	org.apache.commons.codec.net.URLCodecStringTest.constructString(int[])
org.apache.commons.codec.binary.BinaryByteCodecTest.testToAsciiChars()	org.apache.commons.codec.binary.BinaryCodec.toAsciiChars(byte[])
org.apache.commons.codec.language.DoubleMetaphone.handleP(String,DoubleMetaphoneResult,int)	org.apache.commons.codec.language.DoubleMetaphone.DoubleMetaphoneResult.append(char)
org.apache.commons.codec.net.URLStringCodec.encode(String)	org.apache.commons.codec.net.URLStringCodec.getDefaultCharset()
org.apache.commons.codec.language.RefinedSoundex.difference(String,String)	org.apache.commons.codec.language.SoundexUtils.difference(StringEncoder,String,String)
org.apache.commons.codec.net.URLCodecStringTest.testUnsafeEncodeDecode()	org.apache.commons.codec.net.URLStringCodec.encode(String)
org.apache.commons.codec.net.QuotedPrintableStringCodecTest.testDecodeInvalid()	org.apache.commons.codec.net.QuotedPrintableStringCodec.decode(String)
org.apache.commons.codec.digest.DigestUtils.sha(String)	org.apache.commons.codec.digest.DigestUtils.getBytesUtf8(String)
org.apache.commons.codec.binary.Hex.decode(char[])	org.apache.commons.codec.binary.Hex.decodeHex(char[])
org.apache.commons.codec.language.bm.Rule.createResourceName(NameType,RuleType,String)	org.apache.commons.codec.language.bm.NameType.getName()
org.apache.commons.codec.binary.Base64Test.testIgnoringNonBase64InDecode()	org.apache.commons.codec.binary.Base64.decodeBase64(byte[])
org.apache.commons.codec.binary.HexByteTest.testEncodeDecodeRandom()	org.apache.commons.codec.binary.Hex.encode(String)
org.apache.commons.codec.binary.BinaryByteCodecTest.testDecodeObject()	org.apache.commons.codec.binary.BinaryByteCodecTest.assertDecodeObject(byte[],String)
org.apache.commons.codec.digest.DigestUtilsTest.testSha256()	org.apache.commons.codec.digest.DigestUtilsTest.getBytesUtf8(String)
org.apache.commons.codec.binary.Base32InputStreamTest.testCodec105()	org.apache.commons.codec.binary.BaseNCodecInputStream.read()
org.apache.commons.codec.binary.Base64Test.testUUID()	org.apache.commons.codec.binary.Hex.decodeHex(char[])
org.apache.commons.codec.language.bm.BeiderMorseEncoderTest.testLongestEnglishSurname()	org.apache.commons.codec.language.bm.BeiderMorseEncoderTest.createGenericApproxEncoder()
org.apache.commons.codec.net.QCodecTest.testDecodeStringWithNull()	org.apache.commons.codec.net.QCodec.decode(String)
org.apache.commons.codec.language.ColognePhoneticTest.testEdgeCases()	org.apache.commons.codec.StringEncoderAbstractTest.checkEncodings(String[][])
org.apache.commons.codec.language.DoubleMetaphone.handleL(String,DoubleMetaphoneResult,int)	org.apache.commons.codec.language.DoubleMetaphone.DoubleMetaphoneResult.appendPrimary(char)
org.apache.commons.codec.net.QuotedPrintableStringCodecTest.testEncodeDecodeNull()	org.apache.commons.codec.net.QuotedPrintableStringCodec.encode(String)
org.apache.commons.codec.binary.Base64Test.testEncodeDecodeRandom()	org.apache.commons.codec.binary.Base64Test.getRandom()
org.apache.commons.codec.net.URLStringCodec.decode(String,String)	org.apache.commons.codec.binary.StringUtils.getBytesUsAscii(String)
org.apache.commons.codec.language.ColognePhoneticTest.testIsEncodeEquals()	org.apache.commons.codec.StringEncoderAbstractTest.getStringEncoder()
org.apache.commons.codec.binary.HexByteTest.testCustomCharset(String,String)	org.apache.commons.codec.binary.HexByteCodec.encode(byte[])
org.apache.commons.codec.language.MetaphoneTest.assertMetaphoneEqual(String[][])	org.apache.commons.codec.language.Metaphone.isMetaphoneEqual(String,String)
org.apache.commons.codec.language.bm.Rule.getInstance(NameType,RuleType,LanguageSet)	org.apache.commons.codec.language.bm.Rule.getInstance(NameType,RuleType,String)
org.apache.commons.codec.net.BCodec.doEncoding(byte[])	org.apache.commons.codec.binary.Base64.encodeBase64(byte[])
org.apache.commons.codec.language.DoubleMetaphoneTest.assertDoubleMetaphone(String,String)	org.apache.commons.codec.language.DoubleMetaphone.doubleMetaphone(String,boolean)
org.apache.commons.codec.digest.DigestUtilsTest.testSha384()	org.apache.commons.codec.digest.DigestUtilsTest.getBytesUtf8(String)
org.apache.commons.codec.net.BCodec.decode(String)	org.apache.commons.codec.net.RFC1522Codec.decodeText(String)
org.apache.commons.codec.digest.DigestUtils.getSha256Digest()	org.apache.commons.codec.digest.DigestUtils.getDigest(String)
org.apache.commons.codec.digest.DigestUtils.sha256(String)	org.apache.commons.codec.digest.DigestUtils.getBytesUtf8(String)
org.apache.commons.codec.language.bm.BeiderMorseEncoderTest.testAllChars()	org.apache.commons.codec.language.bm.BeiderMorseEncoder.encode(String)
org.apache.commons.codec.language.DoubleMetaphone.handleT(String,DoubleMetaphoneResult,int)	org.apache.commons.codec.language.DoubleMetaphone.contains(String,int,int,String)
org.apache.commons.codec.language.bm.BeiderMorseEncoderTest.testSpeedCheck()	org.apache.commons.codec.language.bm.BeiderMorseEncoder.encode(String)
org.apache.commons.codec.language.MetaphoneTest.testIsMetaphoneEqualPeter()	org.apache.commons.codec.language.MetaphoneTest.assertIsMetaphoneEqual(String,String[])
org.apache.commons.codec.net.URLCodec.decode(byte[])	org.apache.commons.codec.net.URLCodec.decodeUrl(byte[])
org.apache.commons.codec.BinaryEncoderAbstractTest.testEncodeNull()	org.apache.commons.codec.Encoder.encode(I)
org.apache.commons.codec.language.ColognePhonetic.colognePhonetic(String)	org.apache.commons.codec.language.ColognePhonetic.CologneBuffer.length()
org.apache.commons.codec.net.URLStringCodec.decode(String,String)	org.apache.commons.codec.net.URLCodec.decode(byte[])
org.apache.commons.codec.binary.Base64Test.testRfc4648Section10DecodeEncode()	org.apache.commons.codec.binary.Base64Test.testDecodeEncode(String)
org.apache.commons.codec.binary.HexCharTest.testDencodeEmpty()	org.apache.commons.codec.binary.Hex.decode(byte[])
org.apache.commons.codec.binary.Base64OutputStreamTest.testBase64OutputStreamByteByByte()	org.apache.commons.codec.binary.Base64OutputStreamTest.testByteByByte(byte[],byte[],int,byte[])
org.apache.commons.codec.language.bm.PhoneticEngine.encode(String,LanguageSet)	org.apache.commons.codec.language.bm.PhoneticEngine.applyFinalRules(PhonemeBuilder,List<Rule>)
org.apache.commons.codec.digest.DigestUtils.md5Hex(String)	org.apache.commons.codec.binary.Hex.encodeHexString(byte[])
org.apache.commons.codec.language.MetaphoneTest.testTranslateToJOfDGEOrDGIOrDGY()	org.apache.commons.codec.language.MetaphoneTest.getMetaphone()
org.apache.commons.codec.language.bm.LanguageGuessingTest.testLanguageGuessing()	org.apache.commons.codec.language.bm.Lang.guessLanguages(String)
org.apache.commons.codec.binary.BaseNCodec.encode(byte[])	org.apache.commons.codec.binary.BaseNCodec.reset()
org.apache.commons.codec.binary.Base64TestData.streamToBytes(InputStream,byte[])	org.apache.commons.codec.binary.Base64TestData.fill(byte[],int,InputStream)
org.apache.commons.codec.binary.Base64OutputStreamTest.testCodec98NPE()	org.apache.commons.codec.binary.BaseNCodecOutputStream.write(byte[],int,int)
org.apache.commons.codec.language.SoundexTest.testHWRuleEx2()	org.apache.commons.codec.language.Soundex.encode(String)
org.apache.commons.codec.binary.Hex.encodeHexString(byte[])	org.apache.commons.codec.binary.Hex.encodeHex(byte[])
org.apache.commons.codec.language.SoundexTest.testEncodeBasic()	org.apache.commons.codec.language.SoundexTest.getSoundexEncoder()
org.apache.commons.codec.digest.DigestUtils.sha384Hex(byte[])	org.apache.commons.codec.binary.Hex.encodeHexString(byte[])
org.apache.commons.codec.binary.Base64Test.testCodeInteger1()	org.apache.commons.codec.binary.Base64.encodeInteger(BigInteger)
org.apache.commons.codec.binary.BinaryCharCodecTest.testDecodeObject()	org.apache.commons.codec.binary.BinaryCharCodecTest.assertDecodeObject(byte[],String)
org.apache.commons.codec.language.MetaphoneTest.testTIOAndTIAToX()	org.apache.commons.codec.language.MetaphoneTest.getMetaphone()
org.apache.commons.codec.language.bm.BeiderMorseEncoder.setConcat(boolean)	org.apache.commons.codec.language.bm.PhoneticEngine.getNameType()
org.apache.commons.codec.binary.BaseNCodecOutputStream.flush()	org.apache.commons.codec.binary.BaseNCodecOutputStream.flush(boolean)
org.apache.commons.codec.binary.Hex.decode(byte[])	org.apache.commons.codec.binary.Hex.decodeHex(char[])
org.apache.commons.codec.net.QCodec.encode(String)	org.apache.commons.codec.net.QCodec.encode(String,String)
org.apache.commons.codec.digest.DigestUtils.md5Hex(InputStream)	org.apache.commons.codec.binary.Hex.encodeHexString(byte[])
org.apache.commons.codec.digest.DigestUtils.sha512Hex(String)	org.apache.commons.codec.binary.Hex.encodeHexString(byte[])
org.apache.commons.codec.binary.BaseNCodecOutputStream.close()	org.apache.commons.codec.binary.BaseNCodec.decode(byte[],int,int)
org.apache.commons.codec.binary.HexCharTest.testHelloWorldLowerCaseHex()	org.apache.commons.codec.binary.Hex.encodeHex(byte[],boolean)
org.apache.commons.codec.language.DoubleMetaphone.handleS(String,DoubleMetaphoneResult,int,boolean)	org.apache.commons.codec.language.DoubleMetaphone.contains(String,int,int,String,String,String,String)
org.apache.commons.codec.language.bm.BeiderMorseEncoderTest.testEncodeAtzNotEmpty()	org.apache.commons.codec.language.bm.BeiderMorseEncoderTest.createGenericApproxEncoder()
org.apache.commons.codec.language.DoubleMetaphone.handleR(String,DoubleMetaphoneResult,int,boolean)	org.apache.commons.codec.language.DoubleMetaphone.DoubleMetaphoneResult.append(char)
org.apache.commons.codec.language.bm.Lang.guessLanguage(String)	org.apache.commons.codec.language.bm.Lang.guessLanguages(String)
org.apache.commons.codec.language.DoubleMetaphoneTest.doubleMetaphoneNotEqualTest(boolean)	org.apache.commons.codec.language.DoubleMetaphone.isDoubleMetaphoneEqual(String,String,boolean)
org.apache.commons.codec.binary.Base64Test.testObjectDecodeWithValidParameter()	org.apache.commons.codec.binary.Base64.encodeBase64(byte[])
org.apache.commons.codec.language.bm.PhoneticEngine.encode(String,LanguageSet)	org.apache.commons.codec.language.bm.PhoneticEngine.PhonemeBuilder.empty(LanguageSet)
org.apache.commons.codec.binary.HexCharTest.testCustomCharset(String,String)	org.apache.commons.codec.binary.Hex.decode(String)
org.apache.commons.codec.binary.HexCharTest.testCustomCharsetBadNameEncodeObject()	org.apache.commons.codec.binary.Hex.encode(String)
org.apache.commons.codec.language.DoubleMetaphone.handleCH(String,DoubleMetaphoneResult,int)	org.apache.commons.codec.language.DoubleMetaphone.contains(String,int,int,String)
org.apache.commons.codec.binary.BaseNCodec.isInAlphabet(String)	org.apache.commons.codec.binary.StringUtils.getBytesUtf8(String)
org.apache.commons.codec.binary.BaseNCodec.containsAlphabetOrPad(byte[])	org.apache.commons.codec.binary.BaseNCodec.isInAlphabet(byte)
org.apache.commons.codec.language.DoubleMetaphone.handleZ(String,DoubleMetaphoneResult,int,boolean)	org.apache.commons.codec.language.DoubleMetaphone.charAt(String,int)
org.apache.commons.codec.binary.HexByteTest.testEncodeEmpty()	org.apache.commons.codec.binary.Hex.encode(String)
org.apache.commons.codec.language.bm.RuleTest.testPhonemeComparedToSelfIsZero()	org.apache.commons.codec.language.bm.Rule.Phoneme.getPhonemeText()
org.apache.commons.codec.language.DoubleMetaphoneTest.testIsDoubleMetaphoneNotEqual()	org.apache.commons.codec.language.DoubleMetaphoneTest.doubleMetaphoneNotEqualTest(boolean)
org.apache.commons.codec.net.URLCodecStringTest.testDefaultEncoding()	org.apache.commons.codec.net.URLCodecStringTest.validateState(URLStringCodec)
org.apache.commons.codec.net.QCodec.encode(String)	org.apache.commons.codec.net.QCodec.getDefaultCharset()
org.apache.commons.codec.language.MetaphoneTest.testExceedLength()	org.apache.commons.codec.language.Metaphone.metaphone(String)
org.apache.commons.codec.binary.BaseNCodec.readResults(byte[],int,int)	org.apache.commons.codec.binary.BaseNCodec.available()
org.apache.commons.codec.binary.StringUtilsTest.testGetBytesIso8859_1()	org.apache.commons.codec.binary.StringUtils.getBytesIso8859_1(String)
org.apache.commons.codec.binary.BaseNCodec.isInAlphabet(byte[],boolean)	org.apache.commons.codec.binary.BaseNCodec.isWhiteSpace(byte)
org.apache.commons.codec.binary.BaseNCodec.ensureBufferSize(int)	org.apache.commons.codec.binary.BaseNCodec.resizeBuffer()
org.apache.commons.codec.binary.BaseNCodec.encode(byte[])	org.apache.commons.codec.binary.BaseNCodec.readResults(byte[],int,int)
org.apache.commons.codec.binary.HexByteTest.checkDecodeHexOddCharacters(char[])	org.apache.commons.codec.binary.Hex.decodeHex(char[])
org.apache.commons.codec.net.URLCodecStringTest.testEncodeNull()	org.apache.commons.codec.net.URLCodec.encode(byte[])
org.apache.commons.codec.net.URLCodecStringTest.testUnsafeEncodeDecode()	org.apache.commons.codec.net.URLCodecStringTest.validateState(URLStringCodec)
org.apache.commons.codec.language.bm.Rule.Phoneme.join(Phoneme)	org.apache.commons.codec.language.bm.Languages.LanguageSet.restrictTo(LanguageSet)
org.apache.commons.codec.language.bm.BeiderMorseEncoder.setRuleType(RuleType)	org.apache.commons.codec.language.bm.PhoneticEngine.isConcat()
org.apache.commons.codec.binary.Base64InputStreamTest.testReadNull()	org.apache.commons.codec.binary.StringUtils.getBytesUtf8(String)
org.apache.commons.codec.binary.Base64Test.testUUID()	org.apache.commons.codec.binary.Base64.encodeBase64(byte[])
org.apache.commons.codec.language.bm.Lang.guessLanguages(String)	org.apache.commons.codec.language.bm.Languages.getLanguages()
org.apache.commons.codec.language.DoubleMetaphone.handleD(String,DoubleMetaphoneResult,int)	org.apache.commons.codec.language.DoubleMetaphone.DoubleMetaphoneResult.append(char)
org.apache.commons.codec.language.DoubleMetaphone.handleH(String,DoubleMetaphoneResult,int)	org.apache.commons.codec.language.DoubleMetaphone.charAt(String,int)
org.apache.commons.codec.language.bm.PhoneticEngine.applyFinalRules(PhonemeBuilder,List<Rule>)	org.apache.commons.codec.language.bm.PhoneticEngine.RulesApplication.isFound()
org.apache.commons.codec.binary.HexCharTest.testDencodeEmpty()	org.apache.commons.codec.binary.Hex.decodeHex(char[])
org.apache.commons.codec.binary.HexCharTest.testEncodeEmpty()	org.apache.commons.codec.binary.HexCharCodec.encode(byte[])
org.apache.commons.codec.language.bm.Lang.guessLanguages(String)	org.apache.commons.codec.language.bm.Lang.LangRule.matches(String)
org.apache.commons.codec.net.URLCodecStringTest.testDecodeInvalidContent()	org.apache.commons.codec.net.URLCodec.decode(byte[])
org.apache.commons.codec.language.DoubleMetaphone.handleL(String,DoubleMetaphoneResult,int)	org.apache.commons.codec.language.DoubleMetaphone.conditionL0(String,int)
org.apache.commons.codec.language.DoubleMetaphone.handleGH(String,DoubleMetaphoneResult,int)	org.apache.commons.codec.language.DoubleMetaphone.contains(String,int,int,String,String,String)
org.apache.commons.codec.binary.BinaryCodec.decode(String)	org.apache.commons.codec.binary.BinaryCodec.fromAscii(char[])
org.apache.commons.codec.net.URLCodecStringTest.testSafeCharEncodeDecode()	org.apache.commons.codec.net.URLStringCodec.encode(String)
org.apache.commons.codec.language.bm.PhoneticEngine.encode(String,LanguageSet)	org.apache.commons.codec.language.bm.PhoneticEngine.PhonemeBuilder.makeString()
org.apache.commons.codec.net.QuotedPrintableCodec.encode(byte[])	org.apache.commons.codec.net.QuotedPrintableCodec.encodeQuotedPrintable(BitSet,byte[])
org.apache.commons.codec.net.URLCodecBinaryTest.testEncodeNull()	org.apache.commons.codec.net.URLCodecBinaryTest.validateState(URLBinaryCodec)
